session_id,did,resource_consumed,session_start_datetime,session_end_datetime,task,duration
01H65Y8SMXXCZQDMG71YV492QN,did:meca:0xfb7f52bc08f9429d194010c464b180ac490df763,8,1672535294,1672563501,ml_lstm,28207
01H65Y8SWPWSZ3TTWW00E5D1BF,did:meca:0xbf51488773b4fd62543208af582b110f98ee9dea,47,1672539257,1672557822,vr_env_rendering,18565
01H65Y8SPYBC6D5NWE61B1NYK8,did:meca:0x13547261382b35f465355543b47b78142a675fbd,52,1672554682,1672699511,game_3d_rendering,144829
01H65Y8SNCWDXDB652Z3DWKCEK,did:meca:0xebd5ebb1c3a39bd6179bb471b90227e657f8bddd,64,1672564863,1672773848,ml_lstm,208985
01H65Y8SV47SR44C8XD6VZM8QX,did:meca:0x79abb035ca77255fc53576efb4f99f16b338e300,81,1672564883,1672693779,game_3d_rendering,128896
01H65Y8SY1KBK10K59SY3DWQ42,did:meca:0x7d1316a364df74cbf7625ffe1214e26d33f662b1,3,1672584255,1672769796,ml_lstm,185541
01H65Y8SNN5SQG6NCE6EZ3RB16,did:meca:0x54236cdaf5ef4610b4a568803a09a97ac737ca73,27,1672585073,1672779376,ml_lstm,194303
01H65Y8T2V1RW7QXR1KVJ3DJQ1,did:meca:0x4c604aa2a95ff310fd307b2c34d014f244c0a6ec,74,1672585293,1672721250,game_3d_rendering,135957
01H65Y8T1345NPHKD1XK32MJBG,did:meca:0x21878b605e7c0d01f5b0cf6ed15b682c8cc7b993,80,1672600879,1672704582,game_3d_rendering,103703
01H65Y8T4JNN52KH9DXEZG8NCM,did:meca:0x2f2f5fc17a9de0292f0a48744ffa454cb495542c,69,1672647835,1672722263,ml_lstm,74428
01H65Y8T67PKEBG2WZS0YBCQ6Z,did:meca:0x9eb832a118675c607746c0d711191656226c4573,9,1672652951,1672777428,ml_lstm,124477
01H65Y8T0YN19MS2QZJZDY1SFZ,did:meca:0x70fbd122a2e996dbffa86b0a77c453970a89f76c,64,1672680959,1672708524,game_3d_rendering,27565
01H65Y8T84C2EHRETNPJ1AJS31,did:meca:0xd92ba694d0f8c73582e053a218b0be3e77bb9db4,3,1672689214,1672814676,ml_lstm,125462
01H65Y8T11YVZXT2M4APAJ1B80,did:meca:0x9769d582ab1ee245737222e6e3070750d73e3c29,94,1672723757,1672960538,game_3d_rendering,236781
01H65Y8SZX8H411FG7YK84TCRX,did:meca:0x3f1c80d7e132a75e852460f23734f28747551038,21,1672740177,1672753534,ml_lstm,13357
01H65Y8T1C51MR8MA33Z9V1JA0,did:meca:0x7994b2b58c4196d3765b722cb3e5283dc50349ea,62,1672764141,1673073572,ml_lstm,309431
01H65Y8SXYK3547AHMR0FHY37D,did:meca:0x6cf44e8a0799f90ff7fb6a0e3cb246e7794e9d21,68,1672770160,1672956000,ml_lstm,185840
01H65Y8SZ9WTA88B1JQNQHJW46,did:meca:0x36a2e5c9535121794d4f9e74fef4a241037d5a94,33,1672780372,1672916970,game_3d_rendering,136598
01H65Y8SMXR0T2ME6R28CTQN2V,did:meca:0xfb18ee30745784a14d8931729b87b3ad88cd15ab,94,1672828109,1672964995,game_3d_rendering,136886
01H65Y8SWG21TXGV3K03YRW7GC,did:meca:0x92aebd1a2e932399a103a9612df21fa28eab0f85,7,1672836823,1672891581,ml_lstm,54758
01H65Y8T6WQK0ZSD9M8M9SY1R5,did:meca:0x8cb54f9098efa60a33a6a20379df662ef92b3ee3,87,1672838388,1673035005,game_3d_rendering,196617
01H65Y8T5TKP7Z078QMSX9MH1S,did:meca:0xa3872f7bf88496fbd1b6c783d591425226b7b407,25,1672883305,1673020642,ml_lstm,137337
01H65Y8SPKZ8TGTSG3R6ZVBWJB,did:meca:0x7765a3462efe95cb9842a19a33e2a8375b5eed65,25,1672904751,1673016077,game_3d_rendering,111326
01H65Y8SQ2NC4AAA1ENVFYM2D0,did:meca:0xb9c8c3c7578dd2b97bbe8219243486221430312d,25,1672907194,1673199479,ml_lstm,292285
01H65Y8SSHJ95XMZ0NGTQP90YN,did:meca:0xfeb24f9f1075891cf479a972f5ee9f606afea098,65,1672914045,1672932427,ml_lstm,18382
01H65Y8SZ7QPNDVQTZPKNGY9TQ,did:meca:0xe6dfb166635575007d884362c9e589bfe8cac204,100,1672920412,1672941684,ml_lstm,21272
01H65Y8SKHTXRJHNCCYW64R4ZC,did:meca:0xc3286621f2018e25478e24109e244ef8d9a6930b,33,1672935041,1673214035,game_3d_rendering,278994
01H65Y8SQ8WPNX9BJF4J709VTJ,did:meca:0xc166d0934ff739c68f0d9bee607383ba512a3038,54,1672935677,1673148606,game_3d_rendering,212929
01H65Y8SXEK0RMXZ54FY2PT9YC,did:meca:0x95e0180118556ff6b375581075ca21b9c06408c6,41,1672963213,1673028210,ml_dbn,64997
01H65Y8T09GE23SXY91SJPBJ27,did:meca:0x2ea7b3f0e1833c147ba1b22bb208232506e43655,83,1672978447,1673090683,game_3d_rendering,112236
01H65Y8SQME25S6PGB63561PEH,did:meca:0xd5b5f239658224a5da6002dfc58ed64323fd8e4b,24,1672984421,1673225411,ml_lstm,240990
01H65Y8SNSEAV2C4SC9NBNTZ7M,did:meca:0x00a3fc9325c53f5cd17c5b2e169e4975f6260657,57,1672997270,1673002255,vr_env_rendering,4985
01H65Y8SR2ENHAZRHQNYPP271M,did:meca:0x754d888f8f1530cd7451a5e4756eae1a01599764,77,1673002132,1673133867,ml_lstm,131735
01H65Y8SQX3SWW4BCKTDKZ15P3,did:meca:0x3b2c7ce6c05d0ccc2fa3eb51509fb504bdfcda55,39,1673002264,1673041422,vr_env_rendering,39158
01H65Y8T0X8DVEBGABTCCZ9PEZ,did:meca:0xeb6d156fa878cade6fda76a6e93066e77c8c6d9a,29,1673030776,1673203298,ml_lstm,172522
01H65Y8T7CJC1Y9FP94A4FAPSQ,did:meca:0x796e3341b70c0d56d361d1bb562240d99a95df09,67,1673031981,1673051789,game_3d_rendering,19808
01H65Y8SZPWE1WK9T40HVX5MHT,did:meca:0xdfd69f1a0d3f5e3e5c7bce655c2659f6ae39db58,42,1673053759,1673206724,game_3d_rendering,152965
01H65Y8SNTFDP72ESP2G7CMQM3,did:meca:0x035af1b3132c7136d4282af78a7277e847af3b33,98,1673056246,1673156095,game_3d_rendering,99849
01H65Y8T4ZRVWNWQ006RES51XX,did:meca:0x22ae4e726a380c2c619f71efafbdc867877b624b,14,1673071858,1673151514,ml_lstm,79656
01H65Y8SW0JWH7T7R1XM85TX3D,did:meca:0x7c7eb18925c88a55cb170d45c350619e7bd6cca6,8,1673076602,1673271409,ml_lstm,194807
01H65Y8SQ1W8B17KEZFHQAC8RJ,did:meca:0x3533848116c146ac389dd950637012edb8658275,77,1673097946,1673295213,ml_lstm,197267
01H65Y8SKP5TTMGX3E7FHFJKZ1,did:meca:0x68eeda7760a96c48dd07d62c6d5dd7019f31badd,72,1673100362,1673118992,ml_lstm,18630
01H65Y8SPSQVJ1VPYN3545P9E3,did:meca:0xc8daa0a0de32dfb5f2a71737013e1df92b60ab3f,87,1673141474,1673353805,game_3d_rendering,212331
01H65Y8SKXQSPKDH6D3W2A1EB8,did:meca:0xcb4f47049c730f8aa4bb8b3dddded9859008d771,49,1673153704,1673291026,vr_env_rendering,137322
01H65Y8SS0EQ2SE7JRWZTTDNV1,did:meca:0xe06a799e42df8113bda0c6c2b0d23f8c3c514b22,30,1673175436,1673231099,ml_lstm,55663
01H65Y8T3YW5JMD3N0ZXTHDCQP,did:meca:0x76c41ec23519d12705c3c51f1e5a996d036de518,72,1673183394,1673236771,game_3d_rendering,53377
01H65Y8T4EQ387DQ8JQ269XNPM,did:meca:0x35c30e1d9a95bb4c603335e7e38469f7540c9653,23,1673203095,1673290051,vr_env_rendering,86956
01H65Y8SS8N86V4PZK6QJ2BGK1,did:meca:0x287bfec754ea4cec9f111484349776ded09a9212,31,1673205289,1673374346,game_3d_rendering,169057
01H65Y8T6WJHJ20187KNBPX96M,did:meca:0xdebc58c61d67bbf7dbe844bd0ed5590c27618ed4,34,1673208110,1673217391,game_3d_rendering,9281
01H65Y8SQ2R0DWCXXTVD7ECQBD,did:meca:0x1a8e266450887d205bb41fdfe599cf51a7a132b1,48,1673225255,1673251786,ml_lstm,26531
01H65Y8SYTF3X21VAT1B3SN9R4,did:meca:0x89ce744dd5fbb918158eeb684f6c34f068d95dee,22,1673247909,1673703715,ml_lstm,455806
01H65Y8SPWZ2GX4YDBGZ4FWTBS,did:meca:0x2f817caa9baace634f2ea64cfcc07d3e7ffc6073,8,1673256533,1673379936,game_3d_rendering,123403
01H65Y8SXKHEM4HAXNS4JXAYDW,did:meca:0x1722e0078b70e8c19feab3b2b7a811e2fbb90509,69,1673308052,1673378886,game_3d_rendering,70834
01H65Y8STPHHBQ6KVCXJDRE797,did:meca:0x6d2d4dccc36e6c52ceb9699d4ce34daad4a02332,88,1673328519,1673420041,game_3d_rendering,91522
01H65Y8SVFJJXQWQ64XZX70NJZ,did:meca:0x86e295348a645fb3257ec440e425c73618054da3,96,1673366333,1673557589,ml_lstm,191256
01H65Y8T65HRT8QSG5YXHC6CW6,did:meca:0x7d58f12bee2cb93d7be3065114b134ff240b7435,37,1673378762,1673387773,game_3d_rendering,9011
01H65Y8T80ZRGWVAVBVBBVTQX0,did:meca:0x50efdabb53a8478de92c4e8fdc7ae2bb1e81df46,97,1673383519,1673812050,game_3d_rendering,428531
01H65Y8SK3N5NEH1F32DG83ZV5,did:meca:0x5ea14161eeecb12332a7a8b23b8c3ff9c68d6650,25,1673385006,1673506727,ml_lstm,121721
01H65Y8SYNHKCHGY695JYNQSAJ,did:meca:0x03327695f6473a6c68edcf5a2b434e5f42ce6168,58,1673387434,1673390499,game_3d_rendering,3065
01H65Y8SM2GJH4KZJ5N614EAGW,did:meca:0xb4f29bbed4fd2f2e4af21fe112a1868bb0f5b495,100,1673414872,1673586089,game_3d_rendering,171217
01H65Y8SWN7R14977AT6T8T0S9,did:meca:0x8e81e7556c984955c8ef65bd2ed8af6a9d4ea6f8,64,1673440525,1673504974,ml_lstm,64449
01H65Y8SPT3FQ516ZKAMDZV07G,did:meca:0xfb3ac091b19cb7eef8fb58950532c0d52bd63fa0,31,1673440611,1673522369,ml_lstm,81758
01H65Y8SN55BC1GFW7G6ZWNG95,did:meca:0x08d44eec7c09a1b2112cb15b641b7c87ebd60f13,31,1673459002,1673524953,game_3d_rendering,65951
01H65Y8SPR7717ARTQH8KTJHDH,did:meca:0x8d95ac424a477bc2336cda6740d3ae9104437df2,29,1673470866,1673551127,ml_lstm,80261
01H65Y8SMCQJ9KQ6GQ9KZDTCF8,did:meca:0x579a96506bd9a651ba4e4a0778e4e8d6ebb2ba8d,65,1673471675,1673779333,vr_env_rendering,307658
01H65Y8T27R6VBH7N83EJFRART,did:meca:0xaf58f017b2c86d27000a6095e1654e43abd6ff04,89,1673489994,1673761553,game_3d_rendering,271559
01H65Y8T6YAMVS83NSSN6786XQ,did:meca:0x597300163110db519ad4c4f70433629292ce30e7,50,1673510792,1673553122,ml_lstm,42330
01H65Y8T47N1VA00PNPWTW8PN8,did:meca:0xe21b7f37224ee7e017d9e1a56178f7f3bd4f1038,79,1673522364,1673540319,vr_env_rendering,17955
01H65Y8SNCAQ5358YPZBGE910W,did:meca:0x2306c9d2bf517391be1c953ad7007e05ef5cfe8f,67,1673527694,1673583088,ml_lstm,55394
01H65Y8SK8Z1KGMGG8HEV5CZ83,did:meca:0xfbc5bc4604ac99571ff2fa0de23d0a8dc61a4f27,24,1673550834,1673776058,game_3d_rendering,225224
01H65Y8T73MDH90KMH87WDS1XA,did:meca:0x35b97ce6451a23cd737d4dd993d8e3e1c2008ec1,25,1673567289,1673818316,ml_lstm,251027
01H65Y8SS7ETABZRZN6E5ZPY33,did:meca:0xafc6db17a415acd80cf45aeedd4c3c32132a2522,39,1673587204,1673619978,game_3d_rendering,32774
01H65Y8SM73SYVX7C71V2KTM4D,did:meca:0x8829b467027226529b185c38607dc99e0e3d1c35,5,1673621050,1673843418,game_3d_rendering,222368
01H65Y8T2NRNCYDNCDKSB597AH,did:meca:0x0360159f1c51f321e20312ee64d3a848ada87694,56,1673647349,1673874553,ml_lstm,227204
01H65Y8SP7BQZ3XPQ4Y4NWMDDB,did:meca:0x6fd70e3c62a3f52377532fa2f992101a07c66cb8,70,1673649777,1673691439,game_3d_rendering,41662
01H65Y8SSB008P4B6V7Z0F71NC,did:meca:0x073092f0849e48435add1bcfc2d16a3b0eb5fd5a,78,1673663572,1673914040,game_3d_rendering,250468
01H65Y8SVN2E9CA68FF0AYJZZV,did:meca:0x434b89efe82a90e3cb9d5e76a15a2a608a479cc0,32,1673712255,1673750213,game_3d_rendering,37958
01H65Y8T6R6X0Z7Y6P23MDF206,did:meca:0x4ff52c60a9541d76c82bd6e084c21d901cca9073,18,1673762182,1673797311,game_3d_rendering,35129
01H65Y8T5VKCPFMA0JWQVTTH9C,did:meca:0x1720bbef139c3712efbabd0a12049a42a28071f9,67,1673772816,1673788619,game_3d_rendering,15803
01H65Y8SS2Y1HGR799198HTJJP,did:meca:0x59119a4135777db7da85c22b5a6e58eae81ed43e,93,1673788132,1673823384,ml_lstm,35252
01H65Y8SW01F1X7TE7Q0SKQSTF,did:meca:0x3e7ab26a16c2d3f28eb0cba46f08f17dcbedd237,57,1673806301,1673833608,ml_lstm,27307
01H65Y8SZJNMYWK5T635JB7S5Q,did:meca:0x40ef1e3467b27bba5d56c95d8c0debb03455b808,94,1673812970,1673817496,ml_lstm,4526
01H65Y8SQAP82KJKN4EYJWV0SV,did:meca:0x4969c4ac9af32c93b6be9acd80f49b29d42fcb95,74,1673822505,1674026584,ml_lstm,204079
01H65Y8SPDEWDDN5V9ERH87ZQH,did:meca:0x94afca17749649726e01cfa603c264168b9d805f,51,1673844760,1674006589,ml_lstm,161829
01H65Y8T0A3MQ2GGB66XCA1NGY,did:meca:0x4e64c533fd8c1dac032b5e23b3947d6db3f09cd1,84,1673852630,1673929710,game_3d_rendering,77080
01H65Y8STMAG3BE2JFJV94663C,did:meca:0x95e1d5e200b5ae1a955a482456f32eb3fb1adaed,79,1673882732,1673883785,game_3d_rendering,1053
01H65Y8SNWRNAB7KQ7YAWG7AJD,did:meca:0x20439402eabfd0208bfc2281d09ee8b20776e02c,28,1673905528,1673907107,vr_env_rendering,1579
01H65Y8SVDTPG3H5716K8Y4CKW,did:meca:0xbfe07cb6bb247389f67b42fe69d2b325d2966b59,53,1673917829,1674112272,game_3d_rendering,194443
01H65Y8SZ0J0Z82DMXMD2M85GW,did:meca:0xc0c73502d08d3a684f672fd1ced0b1ee3485a010,18,1673945867,1674065308,ml_lstm,119441
01H65Y8SZAA1CTFRVDSR8FHVDX,did:meca:0xfde5368a946fe6be3beb05899d899ca04e3ffb63,39,1673953938,1674153402,ml_lstm,199464
01H65Y8T1VQNE5PN129H03KXZV,did:meca:0x7380912d8f66f3c7cb440b8cca9c15dbff448fa6,66,1673969058,1674103474,ml_lstm,134416
01H65Y8SPNPV56EQAB92KA0MAE,did:meca:0x7e90101d000aa958876e64b008a7e512ef1b003c,98,1673988720,1674169036,ml_lstm,180316
01H65Y8T2HK6MFWWNDG6K48NY1,did:meca:0xea3a27982baefe223320fa8501beb1b3107824dd,45,1673994252,1674127233,ml_lstm,132981
01H65Y8SJD39ZRR177VE3HRQF3,did:meca:0xc558ac2228a2751d0fbcd41c0da0d0c77fece36c,68,1674003411,1674263618,ml_lstm,260207
01H65Y8SR3HJH96PA3FQE2XDNV,did:meca:0x79be600945eb4c47f7042552a3a204071fb56e5d,47,1674008621,1674021540,game_3d_rendering,12919
01H65Y8T39K4DSH1SC79VRDPGD,did:meca:0x06686df20f59f27c7334e926f3a6cca972448dc2,39,1674025841,1674181016,game_3d_rendering,155175
01H65Y8SYV3206H46CQWZ6T56A,did:meca:0xee0e07f763407310c74d35ff912d2dc20ad06c2b,28,1674038016,1674069899,ml_lstm,31883
01H65Y8SP06VQXRMQNET9F6PDB,did:meca:0x53ec901332370c3ad31d23688a1d029512b0a97e,44,1674044198,1674183175,ml_lstm,138977
01H65Y8T3MASP0AHAYNRY1NP0B,did:meca:0xc53a78d30f4110fcdd58c7aaf13812c0d531e17a,27,1674058188,1674174780,game_3d_rendering,116592
01H65Y8SY0NEWNG6H4RFR0JSVG,did:meca:0x9c4a1144e371e6ba4f7dd569d1dd0efda7cb901b,31,1674080122,1674188043,game_3d_rendering,107921
01H65Y8SSG4F3DB125MFKE5DZR,did:meca:0x314f518523b3c8f67e9e17694c89591a8167e4c9,24,1674085701,1674109151,game_3d_rendering,23450
01H65Y8T70R9VM4F55WDGQEJE1,did:meca:0x200167e1cf19368164c9d3f2c0974495c1c395ba,11,1674099982,1674111857,game_3d_rendering,11875
01H65Y8SXNX9HZRNDNC7PGZX6R,did:meca:0xb5604b2c3a271888810b515bed919b7223b4540d,25,1674117861,1674263861,ml_lstm,146000
01H65Y8SKABKFYNKV3FWSTTZ2H,did:meca:0x6e493bc0c8130da6d388f233859abc9bfc343d6d,10,1674130978,1674201083,vr_env_rendering,70105
01H65Y8T3DNB13652KA1YB0WYR,did:meca:0x50611996af8fd6b7428dc88ecf7c5850df8f8a31,25,1674135300,1674348161,ml_lstm,212861
01H65Y8T2D8M5X0FHMVHM4SSFH,did:meca:0x5d4200237b3c51a6620ca5ded5e7da3cd06670c9,8,1674166873,1674213574,ml_lstm,46701
01H65Y8SX5Y49DQBSE6WBW8PRX,did:meca:0xa655eef53413a7763c7df6c191da25f57d18e863,22,1674180869,1674364936,game_3d_rendering,184067
01H65Y8T0K7NWQCMV04HD2S671,did:meca:0x1c187dcb4fa53080edffa9a70ec05a26cd75b701,44,1674201579,1674230680,ml_lstm,29101
01H65Y8SYQFY2YX900VRNXEKR1,did:meca:0x067018d7ddf6ba306d18f25a23fb1cedff4f5b41,36,1674203789,1674260002,ml_lstm,56213
01H65Y8T590R5AMAKG4ZJ3B2YZ,did:meca:0xba20766dfad7a7de7b0bcf8f718478eb57e4e982,78,1674225956,1674387316,ml_lstm,161360
01H65Y8SNXA2A6FE0W8MC21CSR,did:meca:0xa3afbc2e736e44ca41ba35f87acd7960838e9c5e,24,1674228481,1674286669,vr_env_rendering,58188
01H65Y8SR64Z3Y142G86SNE7T0,did:meca:0x8b6ef9756879b4cd0cb9555792904cd259cca6f5,62,1674231715,1674402530,ml_lstm,170815
01H65Y8SW8CT2A5HD0R54VREHT,did:meca:0x3b6800ca17632bb06244b3f7bb1a357987cbb51f,47,1674244418,1674361224,game_3d_rendering,116806
01H65Y8SQEHBV2SZ73KEY5WBMF,did:meca:0x12942b7cb1375f694548feac23ec75343bb44725,84,1674254663,1674345146,game_3d_rendering,90483
01H65Y8SPVDXVMR42MSC251TJ7,did:meca:0x7709e4ffce2bde4cece1ece1937c727608ba9d5e,40,1674256127,1674340988,ml_lstm,84861
01H65Y8SX0RYNZT2NH17CX8CKC,did:meca:0xbf7fecbd336fd8e9ff3db35cd19ef1e46b3042e7,33,1674257417,1674257659,game_3d_rendering,242
01H65Y8SXJAPKNSED58J1BH6PM,did:meca:0x50ce55f530d057cf13642bb24732c1e703599905,71,1674267114,1674396870,ml_lstm,129756
01H65Y8T4QZ2M3NCEDK4H6B3NB,did:meca:0x62dae67283b385c4ee46a21bde1dcad0b81e8bb0,52,1674334841,1674463433,vr_env_rendering,128592
01H65Y8SM5KB27NMJZD3GQET29,did:meca:0xe9841fd664c1c286cfbfb6396997198b60b231ab,16,1674358889,1674608774,ml_lstm,249885
01H65Y8SZKK0TRA1R67REZYX0C,did:meca:0x174238bc6da6b35ad849b1d060390a359813221d,19,1674363352,1674549103,game_3d_rendering,185751
01H65Y8T3EDQYDGZN0R3WG02MP,did:meca:0xe4562a9c24884aa63f36fe009663a43c7ad65217,20,1674366693,1674401326,game_3d_rendering,34633
01H65Y8SSXSGX6T0DR4K9N7ZJ2,did:meca:0x4bea6ab05a95e0eb5ca89e0421e54a3071652800,88,1674386109,1674486081,ml_lstm,99972
01H65Y8SS3D0AEZFCCXGBBJSBZ,did:meca:0x45da33babe88a3a92fff759a9ba199dcd4091ad4,37,1674451230,1674516772,ml_lstm,65542
01H65Y8SK2H5W957DG0VZD2FEG,did:meca:0xc2ef67c566a7519e28f89c6fc595ceaeb3f7cb71,34,1674495611,1674933890,game_3d_rendering,438279
01H65Y8T4R8Y6B6WFV2XJJGPAY,did:meca:0x20922137196b426bcdd6c0e71c2f0b32331ae359,47,1674543065,1674970777,game_3d_rendering,427712
01H65Y8SR776BC7PCAG4MJ3ZXT,did:meca:0x84045da335adcb41af50773a85d50091e4838cc6,93,1674547966,1674661379,game_3d_rendering,113413
01H65Y8SR5K3NJ6MR9Y4V7RE1B,did:meca:0x05570bb285320f27f9cd6c7e9c844269806d2f82,99,1674570603,1674584426,game_3d_rendering,13823
01H65Y8T6YVZ54VPXRKSPDY725,did:meca:0x7ea0b97d9584d1dab68fc1b33a59c089d8312de0,30,1674587507,1674614742,game_3d_rendering,27235
01H65Y8SKV26ERQGC1QEW8WNQ2,did:meca:0xb2418b7677420850685a86257b4e4b91a051a6b4,11,1674596782,1674875900,game_3d_rendering,279118
01H65Y8T04MCQ4V7VKCABV7FJ6,did:meca:0x51ef2bc65e3e8dcbdbccc6199bcc2d176c4d4c0a,5,1674622012,1674720240,game_3d_rendering,98228
01H65Y8SN1TDWG31T1TMVZVMTR,did:meca:0xb2d967936c3e19efbbd803f1db966960f615e910,9,1674648543,1674816702,game_3d_rendering,168159
01H65Y8T68QN8AA5R8MMJA20KR,did:meca:0xa26e09a8814138402e4ce4f9b8b13d225a998bbf,75,1674658274,1674782310,game_3d_rendering,124036
01H65Y8SNE4KH0VDWKW515YA5V,did:meca:0x73396d3692f82e43f609ceecb6bd5884c57baddf,33,1674661814,1674719212,ml_lstm,57398
01H65Y8T388RSF3044F8W98JV3,did:meca:0x125e58caf5c3968b40b60928acf9df4685c5dda1,40,1674662790,1674798902,ml_lstm,136112
01H65Y8T6914ND2ZC3ZR0R1RJ1,did:meca:0x3ab8653348794848f211b2247a884735eb09fc98,47,1674671716,1674812726,ml_lstm,141010
01H65Y8SW3SCWEDBJ7Y66YA5BQ,did:meca:0x24f23d876f397c76a46639dd7698bce2a66ac289,34,1674677748,1674780915,game_3d_rendering,103167
01H65Y8SQDN7Y3A2QTM29FZE8J,did:meca:0x34a9085a238bf77e0c56517da40928ba609e5d7d,68,1674689149,1674964053,game_3d_rendering,274904
01H65Y8SPK6BYW1MVNK9MXHNVQ,did:meca:0x5cba1d595a86bdaf0ba5c7f9fe721bc73c4413ab,16,1674703220,1674824743,ml_lstm,121523
01H65Y8SYCTSVTTFXRAEH8YFAK,did:meca:0xca26769223b5411f39b448b849c98e0ee6eb1b1a,45,1674707162,1674899982,ml_lstm,192820
01H65Y8T06YJT8MQ0HC4774X0F,did:meca:0xc9505d173671513ed28a10bbbec5f4b05dfe7c70,95,1674719672,1674831164,ml_lstm,111492
01H65Y8SMWE3EV6QXKWS2NW2H9,did:meca:0xa8b7685176517a9e6672a897a14b3383793f8b0b,25,1674732808,1674869493,ml_lstm,136685
01H65Y8SNGN9PD36W03PJ5MT6Y,did:meca:0x92f8bd6dcb6f306609658c0a686c6923fb48ae61,3,1674733312,1674976198,ml_lstm,242886
01H65Y8SKSMAHTHZAHE605ZMWM,did:meca:0xfd677adf398063118b466e00c8faac474f6cae16,98,1674761067,1674782655,vr_env_rendering,21588
01H65Y8SR2Q83RA8JAPCTRV653,did:meca:0x2e64c36addcae345784a566ecec17acc78497f0e,65,1674771051,1674796999,game_3d_rendering,25948
01H65Y8T0207HF1JKVRWAG5M83,did:meca:0x3cecee5df66f7f3e0bb621cb72cbc1bd31c755c9,5,1674818762,1674909312,ml_lstm,90550
01H65Y8SJ7SWHRTAZYBSH9RM7X,did:meca:0x3db11265451b32beb6a94256a455f919073970e6,2,1674823199,1675048537,game_3d_rendering,225338
01H65Y8SMHFRRX1FDNW7BDXMCJ,did:meca:0xca229e5439286888d96ad2934da7c84ea30b6848,25,1674838055,1674981830,ml_lstm,143775
01H65Y8SKNB5NEYC5YHNKYPQ40,did:meca:0x10c7ffd99cfd27b263ead5d2028819378289ff74,61,1674879083,1675215581,game_3d_rendering,336498
01H65Y8T0GMCNH34E46GZNYGQT,did:meca:0xf170555c673e0826dadcfc08089f563846ddfd33,62,1674927754,1675000187,ml_lstm,72433
01H65Y8SQJCXC9AEY9TM8KH6YX,did:meca:0x75efb134b85c1cd6844ad9ec5e5bb224e1f71666,51,1674940089,1675173798,vr_env_rendering,233709
01H65Y8SQ176SW53JH7M6PJTEP,did:meca:0xee25d960e32ac47abf5f99c2d77fb012767a3f91,100,1674942489,1675002883,ml_lstm,60394
01H65Y8SM2VKEJFNKQF803A4FX,did:meca:0xc06a55dd959676f6190a1b3fff8a58e69d640038,53,1674959491,1675024766,ml_lstm,65275
01H65Y8SK48JVWK2AH7SW9MJG1,did:meca:0x7e232c8561f292030ac208ad7a9a801b077fd4c8,40,1674967911,1675081969,game_3d_rendering,114058
01H65Y8T6V2QQZXE9E32Y6RKG2,did:meca:0xa2c4406c2d349839014f510688afd0c033006f98,50,1675000164,1675386981,ml_lstm,386817
01H65Y8T1QFH23G2RAGC2SS4WZ,did:meca:0x46606899074eb4bf0b3a4b1a57d7dd1fb01ec570,26,1675006055,1675087449,ml_lstm,81394
01H65Y8SRGE0G4JN1H3PYB00GY,did:meca:0x29e3c22d4f7eef47e56f9f878dc89e84a9f1c295,63,1675007862,1675109404,ml_lstm,101542
01H65Y8T2ZM484B8QNJCE3YSXE,did:meca:0xfe9ce5d5d031793da9491ba09e783a95ff513fea,81,1675009354,1675059785,game_3d_rendering,50431
01H65Y8SRZN9JPS5195PP6NVGF,did:meca:0xe88a9b99a9fb8aece9dbae4af9a448688b20c054,47,1675018823,1675088548,game_3d_rendering,69725
01H65Y8SSECTYXQ56XGG4VTS1C,did:meca:0x6d88ff16ff936c4e21498bb21e563dcebac1257f,38,1675029726,1675225373,game_3d_rendering,195647
01H65Y8SMRR0DH56YY0Z6PWEER,did:meca:0x8516e3d0aadee54713947ca0ac369fbb19983b10,71,1675066264,1675225171,ml_lstm,158907
01H65Y8SVH3KGRK1YCE2QCBCC7,did:meca:0xecf5b54ac6663591d59840b83f326f6aefb2f6d1,40,1675074603,1675221711,game_3d_rendering,147108
01H65Y8SQTHAT13JXQ3KBX93NJ,did:meca:0x19e2fdc4eaf56c4cd84b5c6952b8f262b1dbeeea,56,1675116517,1675145350,ml_lstm,28833
01H65Y8SS9MWRF30Y74CY1GJ77,did:meca:0x2809d77fa2787faf53cd39d92c0170e3fa8b19ea,11,1675157357,1675321880,game_3d_rendering,164523
01H65Y8SXDH1F8GMPB1KTM72PH,did:meca:0xd6ca692b00e40d6220ba516503d56cda835c1b2e,64,1675157492,1675198611,ml_lstm,41119
01H65Y8SMEYXWT4J3SJFDEK8P3,did:meca:0x8d1ec02b53ac18903b3dfec8a09ea33f7b3d2228,86,1675176210,1675341503,game_3d_rendering,165293
01H65Y8SMG9DN93EYYPH9E72DM,did:meca:0xb978f8daff14e8e7f0202a3d4eb81d4cddfe3e70,24,1675181893,1675458189,game_3d_rendering,276296
01H65Y8T1TEXWXDCM5CFAH7140,did:meca:0xc9bc2051bdf89a7775b369bca2d7fc5151e5fd28,76,1675189413,1675242682,game_3d_rendering,53269
01H65Y8SX7XRH7K7HAG77Y2C2K,did:meca:0x79d41c642695b1f9d23643308d4681b959b8477c,32,1675191648,1675210880,game_3d_rendering,19232
01H65Y8SWVXTKD94CA8DVT7959,did:meca:0x4112faa02acb8e26c1b2fd14acaf64dadf58e3f5,68,1675193995,1675214842,game_3d_rendering,20847
01H65Y8T7HHTESE59EN4C5X780,did:meca:0x7475d8eddbf93b7e1fde79d4235c30be3b97033b,44,1675296273,1675371535,game_3d_rendering,75262
01H65Y8SZYAZ0CNW0A1GRPYD7P,did:meca:0x3f2d46eb0026080eee31f9772ec165619da11030,63,1675304487,1675570716,ml_lstm,266229
01H65Y8SQ4G6CW55YAQBZHJPZG,did:meca:0xdb8836f7627b2fa97d221f25a4e73d96688f7631,59,1675313788,1675540452,game_3d_rendering,226664
01H65Y8SZZBF5HXP666CRJMS2N,did:meca:0xadcde14f0e14f19c8a1afba6a6e8ad99fa98dad2,58,1675317150,1675343216,vr_env_rendering,26066
01H65Y8SVFKR6HX18DAFSQ0N2M,did:meca:0x58c66bec37dbf1e3abf7046241f070d98f1730ad,82,1675322147,1675471101,game_3d_rendering,148954
01H65Y8SN0AKDGWXZXP5S9KXKR,did:meca:0x0b4d1efd0bf065758bf97ba8004dd699eb4642c9,42,1675384245,1675443207,ml_lstm,58962
01H65Y8SWK9B98FYGCSRHD30RH,did:meca:0xf4d67c54bf9db5e8ea46627a011dceacdbbfa204,6,1675410402,1675611071,ml_lstm,200669
01H65Y8SWCDTVJYT7801D9B68W,did:meca:0xb79ec4d3b74d20dc35a4abf0b9be6414319a11aa,92,1675415045,1675423626,game_3d_rendering,8581
01H65Y8SJ994B5NCM9SQADPZ00,did:meca:0xdf2523ab390dfe446684b203cb12b995f83b975c,97,1675505829,1675865347,ml_lstm,359518
01H65Y8SW9R334P1ZM2ESB375G,did:meca:0x936c5466295fe7b724d6eed72a07f1798cbde318,3,1675506737,1675620752,game_3d_rendering,114015
01H65Y8T18GD6GPFDWPKW3FFS3,did:meca:0x93b39e74367675403aefcbc277f012231e26ab9a,56,1675536278,1675566998,game_3d_rendering,30720
01H65Y8T3PEYJ5W6V8BQRTSNWS,did:meca:0x2a441b8fa1f6a64a016c93b1dd1716cd95f170ab,91,1675550409,1675742295,ml_lstm,191886
01H65Y8T5R4VJF0TQM8P4311YF,did:meca:0x98191eb746665f5403383f4ba1c7000caf63aec3,59,1675567950,1675632574,ml_lstm,64624
01H65Y8SJXBTDF7CR49A4KPBBF,did:meca:0x232841adb86f03c1662d720c4d6d0696bf4caa87,19,1675572460,1675614373,ml_lstm,41913
01H65Y8SWQJF7Q6B72QTDE5VZG,did:meca:0x70f9095bc8523a22f97a0d5d9c18208f76cae41f,81,1675578446,1675911006,game_3d_rendering,332560
01H65Y8SVRETWTN7ZW6TTXSZNN,did:meca:0x62329f8ae1079550377abf7c94527f07296f3057,37,1675583297,1675784112,game_3d_rendering,200815
01H65Y8T4GX49E1Y9BBDEWFR5P,did:meca:0x4d53897c3c16bc855cc97ee691932623847f16db,7,1675622978,1675652822,ml_lstm,29844
01H65Y8T45R077TMPFPNWTC4SG,did:meca:0x99ce7a1039726381b8d500c1be25c32124f7fce5,16,1675635908,1675758293,ml_lstm,122385
01H65Y8T4YZQ4NF66VY7FSF9WP,did:meca:0xc2a7f98aaf6c1631dc1c30e42f3f5cce9a589ac0,49,1675657806,1675711715,ml_lstm,53909
01H65Y8SYF5742KZ641EBSRV08,did:meca:0x2774bb032142409c43172369b040094409bc0f00,20,1675662206,1675827806,ml_lstm,165600
01H65Y8T6APKR6GTZV9AW6D5S4,did:meca:0x1251b6b63424729c1813284483c8b08fe91d3258,40,1675665322,1675830979,ml_lstm,165657
01H65Y8T6M60KS2ZAW8WQBAGCV,did:meca:0x300b337135888f653694949474d78df44e99c895,36,1675672582,1675848706,ml_lstm,176124
01H65Y8T5MSWVY0WM96FZ6K6B0,did:meca:0xc9cd470da72528f14184f331c71cfb1070799e45,9,1675727215,1675813689,ml_lstm,86474
01H65Y8T7KYV1EMC8JN6CBEN22,did:meca:0xc05ce0676577f295e78329a29e73b641d2eb5f33,99,1675745486,1675760472,ml_lstm,14986
01H65Y8SSKVRSC64R2795TRV14,did:meca:0xb84d8375f7500347187346b39a57c9ade256002d,55,1675773430,1676021313,game_3d_rendering,247883
01H65Y8SXNX9HKV0VKVGNWHW5Q,did:meca:0x06ee679b1d76e27d3a245e28a6d7ef10aad3e83b,62,1675776249,1675837496,game_3d_rendering,61247
01H65Y8T3WRCFNV292M6JV8WE8,did:meca:0xc2dd42508f5ceaa9a7c26fba42e610fe5a208531,58,1675785094,1675879327,ml_lstm,94233
01H65Y8T3A8AVVGE72PMRYADE6,did:meca:0x339fba88588e0907b523e7736a06d34959b65cd9,32,1675796035,1676003066,game_3d_rendering,207031
01H65Y8SZBS2A5R3E0J0TB3XZR,did:meca:0x10467d9a3e51c08281bbd5b4e6e48ef8ce13ca2c,33,1675799201,1675885894,ml_lstm,86693
01H65Y8T521D0V4PB28W7PQQQR,did:meca:0x9105252a4e7c6722a7547d7a022c6b1ae399bdd4,39,1675819984,1675904127,ml_lstm,84143
01H65Y8T4FWPNSJQWSP29S50RV,did:meca:0x4caf9a4a94a33e250b5911c76fc2b9d3e9665070,13,1675825135,1675888351,ml_lstm,63216
01H65Y8SSJJAQHWACMZ2YV76P4,did:meca:0x57484a5914a508b944a626a9f6faf1f6542b69cb,73,1675829615,1675898489,game_3d_rendering,68874
01H65Y8T0XC8E152JXW9HV1DYN,did:meca:0xc57bc056f31e6a6ea062858f08c86ed3ff70e389,53,1675952526,1676066784,game_3d_rendering,114258
01H65Y8T3CGP207P5GFEXX0KNC,did:meca:0x93be348dee11f1dee85a9b0f46ad7cbba6bb8a65,6,1675953376,1676297518,ml_lstm,344142
01H65Y8T5B25W5BQ7JRXT2MKPK,did:meca:0x68ba1cbf7624afe05d4b2de72903a130588d3ad4,59,1675963031,1676059076,vr_env_rendering,96045
01H65Y8T0SHDBGKMKFD4SBS926,did:meca:0xa4c8124da39126565b85ee6f930cb91d6ed880aa,98,1675992590,1676134521,game_3d_rendering,141931
01H65Y8T7BXFTYGJVE5BJK9VRD,did:meca:0xe3085f38ad62f5c8eb6341664ee6fdd32b17a660,55,1675999833,1676036579,ml_lstm,36746
01H65Y8T5Y483RNZXNDTJ6ZSK0,did:meca:0xf34957c05296b9cb367e09084fe2c428c23f308e,71,1676003672,1676121721,game_3d_rendering,118049
01H65Y8T586X5AYW8GSY5KRMK8,did:meca:0x9e6784c56f8666b94fb03670cba10a621e87ecae,85,1676003903,1676089804,ml_lstm,85901
01H65Y8SS7NMNGF1R5MDK9YVN4,did:meca:0xfd2ecd616cbe9244c57ae29c7ac4950fabfb73fc,60,1676017923,1676103518,ml_lstm,85595
01H65Y8T3482D9XDQ3XE1HTSPF,did:meca:0x63a13c39c8a073a0a9e4f9da27fdef375ae61b59,13,1676045444,1676146559,ml_lstm,101115
01H65Y8SR1760SS9W3QFCGSJRK,did:meca:0x41003d7d01e51005e068f01f29b6257d0c4bffff,85,1676056957,1676424581,ml_lstm,367624
01H65Y8SSDDJ2MV9JJRNSN7T1M,did:meca:0x893e878afc2d259f4e2db6787868df0f22450b07,13,1676061660,1676159230,ml_lstm,97570
01H65Y8T7SB5C93YHTWARC8Z6S,did:meca:0xd81b4a4e3a90b505cf20ade4c05fbcbe507c496b,45,1676062225,1676090137,ml_lstm,27912
01H65Y8SXG8HKCNEQY1A524M6Q,did:meca:0x65bd908e5af5dc9ccdc76a959bf2555b3564b0b6,41,1676069315,1676150097,vr_env_rendering,80782
01H65Y8SKF657ZDEVVZ4HC2CZJ,did:meca:0x5e25a197a935bda97df4f985065f0b15ec2d3047,76,1676116790,1676238749,ml_lstm,121959
01H65Y8SKBM9MAJN4JM7TK225D,did:meca:0x656e5658978a08f65471874e72cabfe0f9a2e8b0,24,1676120153,1676172798,game_3d_rendering,52645
01H65Y8T74V5VE064QK2EVPXHH,did:meca:0xa41c01df188d5c7b9a4b99a5f38da28f147f0ab8,49,1676143127,1676241865,ml_lstm,98738
01H65Y8T6NQ8DJGC3S20Y0CM2Z,did:meca:0x6e4692f5dfa46d2a3883eec99202e7abfdb2cb07,37,1676155278,1676309218,vr_env_rendering,153940
01H65Y8T72JN92J5TCTG6ECNT6,did:meca:0x99cfccd88cf3c3a6ec84c5cd49ce32834849a924,67,1676161339,1676209820,vr_env_rendering,48481
01H65Y8SYK0BBZRDQMDGV9EHXJ,did:meca:0x90dcfd39130cfe23e7164fe36a845d040d6124f7,30,1676174570,1676198526,ml_lstm,23956
01H65Y8STZXRD3RHARMKPHVFS8,did:meca:0x0c09579787d65634db1b60461999b124cfcdf073,12,1676186073,1676317518,ml_lstm,131445
01H65Y8SPYJFRNQSX1TD02QPHC,did:meca:0xff3a086aa43ca09c68e2558d77294d2ccfdaac64,27,1676201099,1676263547,vr_env_rendering,62448
01H65Y8SK3A02RXS198HK1DC6Q,did:meca:0x8d74c853313fd9d50a6031b9f21bd78476996b98,56,1676217703,1676249840,ml_lstm,32137
01H65Y8SZ913CAVYPQPA1BY6R9,did:meca:0xd3a83c9bdbe51af291f78a9a6b934b396c7ecd00,59,1676228520,1676241865,ml_lstm,13345
01H65Y8SV5ZX640JRRWXCR1YGK,did:meca:0x39227e7a7af193725b2739a642893e035d887f82,56,1676236059,1676451109,ml_lstm,215050
01H65Y8SMBCBZT010XTF66GMAQ,did:meca:0x6b6b3132d0a09ea090a8363bd594420980b005fb,45,1676294817,1676579029,game_3d_rendering,284212
01H65Y8T0JCN7Q6PWRKFW09NKF,did:meca:0xf68a988fada77c6e8e07b90861b9188c6118c62e,3,1676300970,1676325292,vr_env_rendering,24322
01H65Y8T144Y51BTDVR566AS0Y,did:meca:0xdf19c06aabee73182cfe9d186f30718df5d9924e,26,1676307136,1676422354,game_3d_rendering,115218
01H65Y8SM6KN8A2YT70NBRQDEB,did:meca:0xe6796c36a136183414ac177a53750a5ec6e58d2c,30,1676339850,1676683044,game_3d_rendering,343194
01H65Y8SSS8V4F210METAPVS6J,did:meca:0x5ea92899a16e24ea0cb44f34d9d5307002bea5cd,6,1676395504,1676619691,ml_lstm,224187
01H65Y8SZCNJD10421QKQZ14MQ,did:meca:0x08a3b5346420218df09d33bcf8be0ea0d87fe83e,92,1676396659,1676553458,game_3d_rendering,156799
01H65Y8SXR36HJC0CVFZ6QMFT2,did:meca:0x0308a1a6b9b9be753958d7691d78a4bfedbe8f1b,78,1676402361,1676408534,ml_lstm,6173
01H65Y8SN7K1T2CHNYZJD5TT03,did:meca:0xdeb64a6bce1ca5c58547ea1b45cd628c45c530f6,4,1676410084,1676654271,vr_env_rendering,244187
01H65Y8T1TGER89PDHX7PEBMQP,did:meca:0x3fe90faedf0efaec30a4688e69e57d89c2db8d3e,24,1676458903,1676716252,game_3d_rendering,257349
01H65Y8SZGS3Y3KH83183FWG2K,did:meca:0x3f48b7d2df3daf1db0c41b9811372e5aa540b2f0,80,1676506042,1676925075,ml_lstm,419033
01H65Y8SNZGKJTS2PSCWZQFHP9,did:meca:0xa4253611b5d736eadfc714aac25f4f5986ff19aa,38,1676546062,1676827562,game_3d_rendering,281500
01H65Y8SR8DKENJMMXZPNQFPWR,did:meca:0xccd8a9541030a357e8a57499a6341dcb398d7b5e,22,1676551219,1676729628,ml_lstm,178409
01H65Y8SYETP8X4C2SS769X292,did:meca:0x9c7776351f4ba980dedd06d47f002856b47eb1f4,21,1676606078,1676759877,ml_lstm,153799
01H65Y8SV19GWMHHQYGVQ483W1,did:meca:0xa3cec466f9f7fa00269db49b0494b0dc00b9c726,98,1676679717,1676977946,ml_lstm,298229
01H65Y8SV7SGWDXFCH0FRB2S4S,did:meca:0x311db7cf4388e1ec917a10f537ed3daa7737215d,76,1676690689,1676703547,ml_lstm,12858
01H65Y8SJERM2N54E0TVNXR4RX,did:meca:0xef992a8568ceacf04c9d96bac0f5822ed524189d,69,1676754720,1676897131,game_3d_rendering,142411
01H65Y8SXRQDX1AYKAM7R436YT,did:meca:0x5f1e0b42aa082417ffbdba8a8a85d321bbb29c8a,2,1676766265,1676993536,game_3d_rendering,227271
01H65Y8SYWV5ARSH9F4874WH0Z,did:meca:0x8f7722ffef4c52d26b66965eb0e5834ae2062127,46,1676790756,1677132864,ml_lstm,342108
01H65Y8SQV0PCBD4T4MCWK433C,did:meca:0x04812b00a9b8585d98913e915de7f1514f659d0e,89,1676800720,1676883428,game_3d_rendering,82708
01H65Y8SZ169A6RMRHSJXX70VY,did:meca:0x9d86c4d119e305742456f0ec682d9021a97c5556,43,1676801284,1676870819,ml_lstm,69535
01H65Y8SMM5V4AB6M5ZHAQQC56,did:meca:0x7bf250576a396865205514f5cd44aae563c220c5,42,1676818503,1677042009,ml_lstm,223506
01H65Y8SNY7BE68M7QMQJBFVMW,did:meca:0xbabbe4148b7bca11b1b468fbd8565d65829a7156,55,1676819515,1676886011,vr_env_rendering,66496
01H65Y8SZ2T92RDC8C60H6JHJF,did:meca:0x99eac15384dcb1a4d703d8205143f70c09ce2e7d,76,1676853616,1676915110,ml_lstm,61494
01H65Y8SN2D6GD6VCZMNSNRT7R,did:meca:0xf27343dbada08a2d65b12567af1365bba572c5c5,89,1676871794,1677019685,ml_lstm,147891
01H65Y8SXA0DEVMEYR804FW2ZX,did:meca:0xf5021097ae3175f46760d575fd4958a3d4608f4f,61,1676880023,1676919834,game_3d_rendering,39811
01H65Y8T1WEVA2XRMEJM4SCDEP,did:meca:0x40a6bbe09f33bfd4d270f440797fe142e0907507,91,1676891979,1677162983,game_3d_rendering,271004
01H65Y8T4PX8A50Z0MX892J2VY,did:meca:0x0c972402e7016a6934ef305b00b0b867732dcf0f,60,1676922318,1676968548,game_3d_rendering,46230
01H65Y8T1ADHXJZ9G2YBG655YA,did:meca:0xf84c30308130e561244bfe8c23b6cf648ec10ef3,34,1676942818,1676963978,game_3d_rendering,21160
01H65Y8T46NFGD3RQMA7TVX37W,did:meca:0x9f956a18e49a7fd2baf3950732f779d0c0d6b0ca,36,1676963191,1677007144,game_3d_rendering,43953
01H65Y8T1AZGA1NXGHD0QY8857,did:meca:0xfdc4a1d180b11a8653b2a9afd3a66c11eb69b0bc,92,1676982266,1677222544,vr_env_rendering,240278
01H65Y8T49ZN6CYYQE9XGFPMVV,did:meca:0xbef2dcce92fdd2a34d97f3a64d1e5b7605b7a39c,35,1677033517,1677243035,ml_lstm,209518
01H65Y8SQYKH1GB1NE0B1RZY5M,did:meca:0x4ace3014c6f40aa3359232917e99e87ad70c5958,79,1677053815,1677068028,ml_lstm,14213
01H65Y8SZTA74WNQS8NG08S9CT,did:meca:0x40267847e42a8ea551e592019710f951191a8310,17,1677079291,1677093479,vr_env_rendering,14188
01H65Y8SVQBZ1NQ5WX30254TAR,did:meca:0x3c22e02f7cd69fac5e091c43f8a4467249961ed0,51,1677081928,1677415769,game_3d_rendering,333841
01H65Y8T2PMJDD0MFWJJB99MVV,did:meca:0xdb5f2a176dc06c94304f0d0cc3c93a85340d7797,28,1677099606,1677348002,ml_lstm,248396
01H65Y8SJ5XY6DQ5YZSF268MXW,did:meca:0x2843e01f094507bf6612dd9104b6db6bc4d543f8,51,1677109804,1677355735,game_3d_rendering,245931
01H65Y8SWEBEBBM72B5JFPW67X,did:meca:0x71b92b19fa9d0ed19f5af0e83c29284d4112821b,38,1677137632,1677474320,ml_lstm,336688
01H65Y8SJMZJX5MWE4CWCATKYK,did:meca:0xf20a4e38a47f5fb482f9062f604bdc1c08cdb39a,25,1677140345,1677274687,game_3d_rendering,134342
01H65Y8T7PFVMT67SQJ6M2FEQ9,did:meca:0x39dad1208d60e5135d42bc33c5374c4ada5ddcff,19,1677165866,1677321419,game_3d_rendering,155553
01H65Y8T32PQGKVH6R7FZ7N50Q,did:meca:0x08d7c53145c1ef1228f03b3c702068529413f0e6,8,1677174342,1677214495,ml_lstm,40153
01H65Y8T2SS2DN429BF6817SVY,did:meca:0x14571645284919e220319a0d995d61e9242e6157,9,1677183685,1677443437,ml_lstm,259752
01H65Y8SXCVHF4QZRHQPSJH162,did:meca:0x298a2baefaad2bef7e18f3983234cf95bb25ff3f,77,1677197075,1677271704,vr_env_rendering,74629
01H65Y8SX8STTCTSFYSTFHV3FJ,did:meca:0x37fd5305599a7673eba6453a291368f26b8a184c,27,1677248505,1677298743,game_3d_rendering,50238
01H65Y8T6Z5D8G2PKPBYBRBTRQ,did:meca:0xf97a84e5e484c9227dfdbdc4db3dc21ea3578139,98,1677258575,1677568036,ml_lstm,309461
01H65Y8SX8VXXCE2Z9AQTGWYA2,did:meca:0x5044a61d745edb1313f7e55e2ec1bb7b7b1454d7,63,1677288800,1677440896,ml_lstm,152096
01H65Y8T33F6MZ8N1E6AYPXT7D,did:meca:0x858623f074f6c0def61eaa906f6a206b511fcf1a,91,1677349227,1677440508,vr_env_rendering,91281
01H65Y8T5FZX3RASTFBENTAX7E,did:meca:0xb2819e687ede88450341505f648535792041e926,43,1677372684,1677378904,vr_env_rendering,6220
01H65Y8T0FFPKRQK2JD8EYKNYG,did:meca:0xb7b8a21b5cb7fa5226ced3cfd66901c9bcf24c29,36,1677392027,1677538126,game_3d_rendering,146099
01H65Y8T0P5HJ2CKMPMS83HZ5N,did:meca:0x78edfe94cf0663e5d9e316d010b173b00cc0b6ee,84,1677395291,1677651242,game_3d_rendering,255951
01H65Y8SMH3PR7VQPP6W9F2JRW,did:meca:0x29ea85b6d484f7eab02712f608a962e13f52a093,99,1677409725,1677628446,game_3d_rendering,218721
01H65Y8SMV9PWN0Z9Y9276W8TN,did:meca:0xcc89c2d8bd9227f2d0e3c9272b9194c2a75116f7,50,1677410016,1677612884,ml_lstm,202868
01H65Y8T56MJND628XMTFVY1NC,did:meca:0x62a2e03232d7e8a6f408c9dd4749760f2c61e3f6,48,1677439152,1677518247,vr_env_rendering,79095
01H65Y8SV3DT1WSSGH3G5CWE9M,did:meca:0x221b8d87ad7ae45144acf19ebd04a138368a3bc5,15,1677451253,1677795431,game_3d_rendering,344178
01H65Y8T28Z7ZN7MYG7MS2R8DE,did:meca:0x1c88fff9a2d9084fd5fcb3661cdc1ea66789145c,60,1677453376,1677477444,ml_lstm,24068
01H65Y8ST6V61NRDD7QVFMPDW0,did:meca:0xc41dfca23730987112fae4cbcaef920703b3c6f5,44,1677466374,1677487060,game_3d_rendering,20686
01H65Y8ST75J7XPSFF94CP6F02,did:meca:0x6194decfcac6bb36a4aef81aa22d1b8be14732ff,53,1677492031,1677628790,ml_lstm,136759
01H65Y8T828ZQMRHC9X27BK504,did:meca:0x8be23681e278f8d38ab80177fb97af5464c11210,20,1677501596,1677512628,game_3d_rendering,11032
01H65Y8T4MV4DF6XXQXQ6BVF3S,did:meca:0xd651200236c2f244076d9e3a85b04af7d1c05da9,22,1677508040,1677822612,ml_lstm,314572
01H65Y8STR3ZBJYQC5EJEBPM4M,did:meca:0x359582d318a67b5c982b702c033257468c2c2d11,45,1677525762,1677549057,game_3d_rendering,23295
01H65Y8SZDQ3PYKHC7SG53CFAA,did:meca:0x54eb44ba4760d3fbc53be0fcd080e8870dd3d458,29,1677584378,1677660585,ml_lstm,76207
01H65Y8SY3D67M84ZA1PBPZ1RG,did:meca:0x4da4dff03ae8843ce364199b74511a2d53cd2f9f,76,1677594212,1677726577,game_3d_rendering,132365
01H65Y8SKFM91AV2N58BM7CSGA,did:meca:0x99b834478b3e8d1679fd0d204a40fff0ffc530e1,35,1677602139,1677721246,game_3d_rendering,119107
01H65Y8SMR2A910TS41JB0EJKX,did:meca:0x57167f8efc8b9ce9b8bfc2c9936f78bfa4629eeb,20,1677610244,1677685391,ml_lstm,75147
01H65Y8T0N8CNFB1V6CKXKZCEN,did:meca:0x0f44e64b101a81db7f985988af6d27f4ec74883e,94,1677632855,1677972047,ml_lstm,339192
01H65Y8SJQ9ZBRWV2H0A64N2WZ,did:meca:0xe579584fd807d9f063585fd20d3f14c6e1e53c0d,23,1677654689,1677655605,ml_lstm,916
01H65Y8SWZ9FXG1XZEBW53WW7Z,did:meca:0x1be1f56d24022a6e21f92a7826f473b331e3616f,66,1677671021,1677725889,game_3d_rendering,54868
01H65Y8T3GTD1VJKEG54F258TC,did:meca:0xa1592366f9039cfe71412639394cbe8a8b58d4ad,19,1677684673,1677885305,vr_env_rendering,200632
01H65Y8SPDCWQEETBB5H1NSANV,did:meca:0xeccda8fa3a1270b0e04afc7ae2685ec23a6a75cf,70,1677693103,1677930748,ml_lstm,237645
01H65Y8T4777PJ5K0H107004MW,did:meca:0x0d955df6ae4eab62712011c1f3db29a57df8a353,2,1677703622,1677791430,game_3d_rendering,87808
01H65Y8SX613F6APFN8N90H0PZ,did:meca:0x7d197bd3c93955aad859530c50c5628bb9af00b4,17,1677719168,1677769250,game_3d_rendering,50082
01H65Y8T3EC5F9R21PDJ3TF4JW,did:meca:0xaf3fa6b00b5d648f5f44155c4479055dd94119ed,64,1677733996,1677790900,game_3d_rendering,56904
01H65Y8SRRX5FP8HGXZVBD39M4,did:meca:0xa1c4b5fd76c921f8ec8c18e290adb853dfc55c2e,23,1677749819,1677822117,ml_lstm,72298
01H65Y8SZNW2E6F4X5MAJ3GGM0,did:meca:0x1cd8493a4db84e676d5e9216ec14aa9c45d9cd2e,29,1677764414,1677866304,ml_lstm,101890
01H65Y8SVXR1DEECG5YBVCXKBV,did:meca:0x96119c881381836c8bf5eb72abac54bccf3ca2bb,56,1677819128,1677827148,ml_lstm,8020
01H65Y8SZSP3N9J0YHET19GTS6,did:meca:0x2107eeb97d6cefb5fc751d2894be379d7ec6ed7e,71,1677852346,1678177396,ml_dbn,325050
01H65Y8SM9Y8DWWVT2FJXQW2HY,did:meca:0x2b995fde4b9ca3bf35acfbb29807027a335cffc8,34,1677853438,1677949739,ml_lstm,96301
01H65Y8SVC33AASYQFWK0C8SNX,did:meca:0x48b82eb06ead2bc559b79746b9b9968ae85b784f,77,1677862830,1678052313,vr_env_rendering,189483
01H65Y8SWYBPKWNSQQJ4MAYXDT,did:meca:0xd1f5b4f9a1ec25b986569efb502f8f35567e2a54,79,1677955336,1678159564,game_3d_rendering,204228
01H65Y8SN3QK63558VP7VKY5J5,did:meca:0x0a7c4819a7f30e31a84511ee6ada944a473d8dfa,42,1677959255,1678158777,game_3d_rendering,199522
01H65Y8SKCKBWMQVBKYZNZ0GZS,did:meca:0x76af444a0c23706f48cbc6d0b8fd043b9d61f158,78,1677962509,1678025298,ml_lstm,62789
01H65Y8SN01T19ZCB4KYVFB4KH,did:meca:0xda393de4757672ddf006f904a5f735da4776bc63,46,1677990295,1678191732,game_3d_rendering,201437
01H65Y8T7MK32705B0RYPWJTY8,did:meca:0x4b72bde6e87580f7b533c2f2e10485998a169432,92,1678001370,1678003979,game_3d_rendering,2609
01H65Y8T54XN7Q1AY4PQE7H12C,did:meca:0x16fe94a8e159156ba5ca92eec7d5670fac0317ea,46,1678012353,1678045470,vr_env_rendering,33117
01H65Y8SZ3M6M07CGY2165YVPZ,did:meca:0x3ac7c9a3a89cf3338fd4316e22b1fc8128a49e05,76,1678016803,1678171865,ml_lstm,155062
01H65Y8SVSJKA7VG4XWA37XPMG,did:meca:0x4b43aa2409f7ddf261b81179a0c4724859f191a0,58,1678037042,1678119720,ml_lstm,82678
01H65Y8SJ289QMY34B7YB3V4V7,did:meca:0xf9b482e25dbc722c9268444979ecdfb9ed894a54,7,1678079066,1678307360,game_3d_rendering,228294
01H65Y8T358FK5YCJ4RQ7GEQ34,did:meca:0x23ac3cb077046407cbafa3998e19cfccfc8ef974,17,1678082431,1678246721,game_3d_rendering,164290
01H65Y8SM75MR7ZTCJHFM262TX,did:meca:0xcffbe9be9e6eb76a3ce9bcb71593ea3dcfa623ef,97,1678099113,1678269669,game_3d_rendering,170556
01H65Y8SP57B36DWDQGQY26MPH,did:meca:0x2c6709fd72968eada8926efbb6fd2d9d3789142b,68,1678101022,1678112026,ml_lstm,11004
01H65Y8SS67PDSH54ZV5X52G6H,did:meca:0x4ae6a1c6641fa6c052cc867947c64a139d782062,8,1678115870,1678400500,ml_lstm,284630
01H65Y8T0VS5C5GR7HNCJGN350,did:meca:0x6cc58cdaf44b6291e69fd91d91e8c18e709e1470,50,1678144373,1678425421,ml_lstm,281048
01H65Y8T4AAHQZJ7RH182RZWGC,did:meca:0xe62446013e424ff335120981fed8d4284279fda1,54,1678192273,1678205425,ml_lstm,13152
01H65Y8STRTGY99WARA2CSQH1N,did:meca:0x43af0feac1d4a4c33c40759d67f73e031f393af0,10,1678199833,1678218496,game_3d_rendering,18663
01H65Y8SYQNAEK8A12HA2KM0CQ,did:meca:0x60c2555dd1be21464b9c196b332107f5ed3ca3a4,90,1678203643,1678282894,ml_lstm,79251
01H65Y8SQEZWEF16GKKR2SGZQY,did:meca:0x8fd8c1ac69a69a58fb789f24f687d2ed149243a7,85,1678214450,1678471299,game_3d_rendering,256849
01H65Y8SMDQDG2CR0MBC8BKP36,did:meca:0x23165e17a4fb9ddb1d70e5491701a4fd8097e5cc,79,1678246265,1678465846,game_3d_rendering,219581
01H65Y8T4DG1PZW403KPRH7D54,did:meca:0xd55c3e762572821b1e0aef72490c5ac0006fa027,78,1678256125,1678549687,game_3d_rendering,293562
01H65Y8SJFYB5NZ20T7JDNKZ8X,did:meca:0xd447692e1362028f7636354508cd23851723749a,28,1678259646,1678349986,game_3d_rendering,90340
01H65Y8T3HFS1DAHAW8NS5N0RH,did:meca:0xbb2fc554ee7faef0f18fa426fda7d74c7c893b85,7,1678264251,1678338121,game_3d_rendering,73870
01H65Y8SS0KVZHVJR0K061CA7Y,did:meca:0x5bc06accf5972d2e99d243e04405fc57cada6e6f,86,1678293793,1678344001,ml_lstm,50208
01H65Y8SWX2SN0R4Z7H2C1NW82,did:meca:0x9dbb5211af9abaab93a23102424d6e6340c4c149,5,1678305559,1678325121,ml_lstm,19562
01H65Y8SZFHZ219SSB7Z0ZXCQ8,did:meca:0xad30d4b4daae7aa408eae9184682764c8c2aa013,2,1678306703,1678807774,game_3d_rendering,501071
01H65Y8SYYTJMWD3T1VAM4961D,did:meca:0xcfdbc409534d9b793c548a18e1a123c2acd9aa19,71,1678350310,1678383569,vr_env_rendering,33259
01H65Y8SKC3ED7Q4H9DFC3A50T,did:meca:0x61745b0f6ba651cb67fc09c8e2a660a82787c287,1,1678377510,1678552014,ml_lstm,174504
01H65Y8T3SWXTE5KQB4HKQNCZ1,did:meca:0x3b9875b2315fb69128041251a017fa2b1b0b0549,56,1678383214,1678738715,ml_lstm,355501
01H65Y8SN412W3QHCH59JBCS18,did:meca:0xe52e5e1f9caf2da43de9f2ead54019186e3d7f9a,4,1678388766,1678509577,ml_lstm,120811
01H65Y8SMYCM9Y3HYQ2Q75ZZVG,did:meca:0x93ac6065f0c46374e42c56a255ab5a4757e3f721,78,1678404166,1678435282,ml_lstm,31116
01H65Y8T6Q1K5SWS66YRZRZ68R,did:meca:0xc71456a6203fafe9c87328c79aa6ec18f016471f,85,1678410098,1678547799,ml_lstm,137701
01H65Y8SK1TGRRAHA2HFMD42Q3,did:meca:0x31395a36d4288771db5e5f93aadd3a7ad13e7032,61,1678424173,1678444485,vr_env_rendering,20312
01H65Y8SSYG2085VBMNVPVS87X,did:meca:0x7af1fd34fb7890fe561aa333221f11164239f09f,60,1678427321,1678540424,ml_lstm,113103
01H65Y8SQ9QPAQ4TDQNHETE4CP,did:meca:0x73fc5ecc644c84d83df54f513b55bc4b71e4369d,23,1678492697,1678531605,game_3d_rendering,38908
01H65Y8SRP8MWY3H1GAXK0A12B,did:meca:0x4142bd4e4ae20b987204f5548b934f48047ee187,90,1678510790,1678523464,ml_lstm,12674
01H65Y8T3XKWQ4HWXS7W0M50ZQ,did:meca:0xbdbf981b0bf4077b46cc99deb0c73f020a65afd4,42,1678521316,1678871339,game_3d_rendering,350023
01H65Y8T487YFZ62SYB99M3DJ6,did:meca:0x76d62b9784a46d2f28463b517450bb56cbb0587b,73,1678530091,1678746327,ml_lstm,216236
01H65Y8T3GZHD03G9X6WNXTC5N,did:meca:0x7adbb0cb30a6dd680459177f448b3929af7f05a5,60,1678537919,1678883277,game_3d_rendering,345358
01H65Y8SWMP4GAFZPJ4FPCJ2V8,did:meca:0xb2ee713da715881bd3c445f490d4743f1805444c,56,1678539212,1678589008,ml_lstm,49796
01H65Y8SSA323SYN2KJ81Q83CB,did:meca:0xaf61a66f2589cc95959d76d764e642e7766141cd,68,1678542982,1678718386,ml_lstm,175404
01H65Y8T50FMTRCVME2SBYN47W,did:meca:0xf7ab897d30c85ada49d27b0a675ffb9dff8fbff9,30,1678587581,1678598874,ml_lstm,11293
01H65Y8T1MSPDSGYMP2HTKWVYY,did:meca:0xa0954974e499ae8596c556351f2023ecce21cf24,36,1678592359,1678802500,game_3d_rendering,210141
01H65Y8SKSMTAXT526S6EBZDJV,did:meca:0x612ec0aff83a4efb51512284dcfdecbb351966cd,11,1678612244,1678981847,ml_lstm,369603
01H65Y8SKRJFJMPYT0QKPH2WHZ,did:meca:0x4251aa24b56a2b99daec83cfb29854ea3cfb8737,38,1678622637,1678669816,ml_lstm,47179
01H65Y8SJNF8WT72Q1Z92KN9B0,did:meca:0xde5e07f6605eae7d52c73e2267a771526fc083ca,96,1678629655,1678970172,game_3d_rendering,340517
01H65Y8SZQ01R5HTXBD6PZBV42,did:meca:0x7421e4b2505a015b15a4d60c03af7fda7cece05f,87,1678645355,1678732638,game_3d_rendering,87283
01H65Y8T6SYS77DSQ731TQQDBR,did:meca:0x7d5bcabcea5535f24fb3d84f6e43d50d2b20006b,48,1678687711,1678833397,vr_env_rendering,145686
01H65Y8SQHGWPJ0Z73W42YWW12,did:meca:0x659761c7d72086e1980f139d49c798a28fe9f1f8,68,1678700008,1678728812,vr_env_rendering,28804
01H65Y8T5HRNKN4D4DD3F9RVD6,did:meca:0xe2f9ec882226197ef737a4e4abe2bfedc251b60d,11,1678708096,1678810475,game_3d_rendering,102379
01H65Y8T5PAB72VAXEQJ61QM22,did:meca:0x18bc6acfe08580379ad5973daacd36f67b937731,20,1678763082,1678795334,game_3d_rendering,32252
01H65Y8T3W370KF76SVACQQBGP,did:meca:0x888ebb2b378e6c83b86b5ef1bbb3673d0b0010be,52,1678785588,1678823179,ml_lstm,37591
01H65Y8SXHD449K9CT6EB3GJ0J,did:meca:0x189286007d7cdc3e88c9b0c9666972c04a581243,67,1678807797,1678852505,game_3d_rendering,44708
01H65Y8SNAPZ1NQ463A5RW1P3T,did:meca:0x9af0086ae917a1e7fe608e0343386c3a9aed5e4f,22,1678820362,1678917982,game_3d_rendering,97620
01H65Y8SV601G25EARJRAT513Q,did:meca:0x9e21624daf7b7f2419178f59a5b5cf6e7d233262,93,1678879576,1679106629,ml_lstm,227053
01H65Y8SSXYYYZGQB6SBE10M1H,did:meca:0x72330dcbe278a4b332781e326ca616b923b7afc3,44,1678898386,1679182053,game_3d_rendering,283667
01H65Y8SQ39653D2ENM7ARC14S,did:meca:0x4b1c07484ce2edadb22b787bc1fff91034b01bef,29,1678913337,1679123919,game_3d_rendering,210582
01H65Y8SR15YQ3724JVF7NBS7Q,did:meca:0xa7c580451d9820741eda157efc759107503d9787,78,1678915796,1679000482,game_3d_rendering,84686
01H65Y8SRHWQF5CRJ487W4TEJK,did:meca:0x35cd6a84896759996af6d3ddba8c1a00e5e689fc,81,1678916720,1679120053,game_3d_rendering,203333
01H65Y8T6TS5PA8RKFZ6B134F3,did:meca:0x63ac3ce8b40dc96800b5b694f98dc21cb559a752,5,1678929178,1679219453,ml_lstm,290275
01H65Y8SKH5D43DJSSATJP216R,did:meca:0x04991aed931c1a027b844689eeec8512d80717df,67,1678971592,1679220044,ml_lstm,248452
01H65Y8SRS1ZCZJ68TNNQVY3C6,did:meca:0x9aad4b4bc6833407bc6f1f03f4c25f8f38c3d9c8,79,1678977832,1679145628,ml_lstm,167796
01H65Y8SVG0F0ZTTVQCMXY5GN9,did:meca:0xee13f322e913aafa19c76cdb025fb8693b754680,40,1679011378,1679251537,ml_lstm,240159
01H65Y8T6XRP6XH9WRN84SA4ZD,did:meca:0x0ba039d9ed349bafb281c1c37deefe529b2beb47,15,1679012466,1679073257,game_3d_rendering,60791
01H65Y8SQ6RTEE1BC3DXTMZ3CG,did:meca:0x34da2b705be798bb1ef762609cc77d384bcef428,32,1679020965,1679022613,ml_lstm,1648
01H65Y8SSBR8B8B0M54QWKKN46,did:meca:0xaec8b266479b6690d9f0fbd5596e3f5df77e967d,21,1679062176,1679111465,ml_lstm,49289
01H65Y8SZNK5NQ0JF21FCZ2JM3,did:meca:0xcc53d67c4d62729b900956a8202eb7edb8bf70ed,37,1679073031,1679085060,vr_env_rendering,12029
01H65Y8SRN2DW6Y7EVKB9NGS1K,did:meca:0x02a9a5d7e1a0c8c0e3ed020f725f6568e1de7560,18,1679078813,1679308748,game_3d_rendering,229935
01H65Y8STWB90DKCPPADD8JTEX,did:meca:0x0daa79639690a212dfdae921627ac5d50ec2768d,93,1679107397,1679228690,ml_lstm,121293
01H65Y8STX2Q7ZAEJ1N8TN9TW2,did:meca:0x3bfc55ae9d70b74e6a16f375d20310925c690c89,81,1679132415,1679319631,game_3d_rendering,187216
01H65Y8T5XZX7K8D3B6YF833JT,did:meca:0xb3390755382d1dd51ce6722ac98d9ff5db717c53,48,1679142450,1679427048,game_3d_rendering,284598
01H65Y8T16VA7FS3ZSHM3AQXY3,did:meca:0xe2577461aa0d304f0198faec945fc457d4070242,45,1679146674,1679499253,vr_env_rendering,352579
01H65Y8T53MF5E5WB7A5QHYYME,did:meca:0x227f7c85820221a1dec6506e8af94213540d2dd7,30,1679160881,1679211116,game_3d_rendering,50235
01H65Y8SS56522DWX3121YRW7P,did:meca:0xf2fd0adf2bd6e4b0a5ae0d5054af346aa07dd507,52,1679174162,1679402755,ml_lstm,228593
01H65Y8SW27YQW4XMRJ7D02AQD,did:meca:0x6d0a44d478d630dbe0cfa872c73cdddabe995380,85,1679227611,1679380285,game_3d_rendering,152674
01H65Y8T4T6DYTYPGNGRHXWRJS,did:meca:0xcb18300b0aefcda8093219322e67557de45a5d35,23,1679271124,1679509413,vr_env_rendering,238289
01H65Y8SJ8QEFM33PB41DKY384,did:meca:0x69c039243d7d2c95043202185fc55cd45b827422,3,1679279013,1679559404,game_3d_rendering,280391
01H65Y8SY5F0DWERDJHZQ2GY7A,did:meca:0xdfd77f0b34950d9a69744633ae1ff71e7a654539,86,1679289004,1679318279,game_3d_rendering,29275
01H65Y8T2GV4AJP4ZAQPMP0XC1,did:meca:0x91cf3f013aed875c0661bf9e630af6edc3fac769,76,1679297464,1679345628,game_3d_rendering,48164
01H65Y8SYS69H02JV61HAMKF24,did:meca:0x7cacf544b690857dc5cfa79ddbef27734f501d72,96,1679301240,1679471131,game_3d_rendering,169891
01H65Y8SNVKGV2RJVS599JDVBQ,did:meca:0x46f47cd382b2781c6d84bb9c4fe8a54fee64a711,29,1679302811,1679424161,game_3d_rendering,121350
01H65Y8SQGA7JMGTQCECY2J4HC,did:meca:0xf956a0102ece0dc44ee936f04f8cff073cfeff7c,93,1679310365,1679374598,game_3d_rendering,64233
01H65Y8SKGGPP46RWPGXW02C6S,did:meca:0x617d18e308a882b2a871e38e940c68cbbff1df69,24,1679317705,1679321292,game_3d_rendering,3587
01H65Y8T625EPC5ZZV0350TM5E,did:meca:0x67f268aea3076f3a577b5f7a3ca7c7ba3ff22752,4,1679335173,1679412731,game_3d_rendering,77558
01H65Y8T518WGTPK18ES4P5DB0,did:meca:0xf91003e5b0e48c5d7ff783eb7e2afbfaff0312b5,37,1679366102,1679623619,ml_lstm,257517
01H65Y8T0EB4R1RR1CTQV3PWM6,did:meca:0xa1edc971faa8151a0d22a0110feaa2efd31b1602,80,1679379702,1679489627,vr_env_rendering,109925
01H65Y8T32Z8ZEGRFB2A2RD1CK,did:meca:0xd048cace0addd4ee2e2023afd7278ec8eda7c56f,100,1679385582,1679689338,game_3d_rendering,303756
01H65Y8SZ7HK55MT2Q7BPDSGH2,did:meca:0x0c398dc77b5fc1e3912f84ce108bbc5c4d66faaf,99,1679412962,1679494280,game_3d_rendering,81318
01H65Y8SP437439ZYGARCHW140,did:meca:0x84599d01a704180cd5c96976e882af60aaf11066,19,1679413384,1679633928,game_3d_rendering,220544
01H65Y8SV9K83CXTWWA5P0H7SJ,did:meca:0x30f92fd50bbba91c09e395f9fba96ff6ba2577a0,27,1679440572,1679784013,vr_env_rendering,343441
01H65Y8SMBEMAYQDHNR6595ATY,did:meca:0xa580e430ba876aa161939ddf2645bb8ba30c2805,22,1679480501,1679567356,ml_lstm,86855
01H65Y8SWTRBY7MNBD6F0KEHPW,did:meca:0x02aabb1260b3ce90c70cac2714a6c961dd857922,38,1679487837,1679561649,ml_lstm,73812
01H65Y8SZZ9QBJTRZ9MR577KF6,did:meca:0x722a150d34f4f8dca20e4e2fe81db7ee52894165,25,1679490918,1679503214,ml_lstm,12296
01H65Y8T2CCGHHDGNTRXBTCD5Q,did:meca:0xa17cfd081dbbf77f78e21bc13d2eae8afa0b6e72,66,1679510601,1679540763,game_3d_rendering,30162
01H65Y8SSVQGD0Y2SWJTQPWYS6,did:meca:0xbc7efc68324d4656cdec139412ad81512d079054,97,1679528773,1679813112,game_3d_rendering,284339
01H65Y8SPEYEAFYW7Q88YF4SJM,did:meca:0x92a635511a83b2fe7e0117b3ee213388080dc895,83,1679529697,1679593878,ml_dbn,64181
01H65Y8T7H6S6BD5N0EJ0R15MT,did:meca:0x0cd181d809066371fd3ed8cb2bb13a81a8d25e05,12,1679539520,1679546369,game_3d_rendering,6849
01H65Y8SZ3YN70EM80W13KRSX9,did:meca:0xc8cf8822f45efd2f39728905d18f4647e2bb314f,97,1679566741,1679681750,ml_lstm,115009
01H65Y8T2YVMYAPNHWSQTBFNTZ,did:meca:0x32751abb3c2b12e884709036829034ccdfb85a7a,34,1679568153,1679888104,vr_env_rendering,319951
01H65Y8SJ3G9JFJTCNWYCNGCVN,did:meca:0xf346856abd17cbddaf1bcc9562003247073c70db,12,1679575582,1679591842,game_3d_rendering,16260
01H65Y8SSTZFT188ZZYRMDGQSF,did:meca:0x0725500911a853f1c3ef8555fafd58ff327f76e2,89,1679624979,1679832813,game_3d_rendering,207834
01H65Y8T6NHTBB5J8ZQRADZ9H7,did:meca:0xdeea259090399e33f23adb595bf80977a4f44bb6,31,1679632366,1679696664,vr_env_rendering,64298
01H65Y8SPR0W0VK9QXJAS1FVGV,did:meca:0xee65e55a29739e82742e6bfd3686e0d10c5c824c,52,1679635306,1679685779,vr_env_rendering,50473
01H65Y8T5EQJMS0HMWYJW75B26,did:meca:0x2dedb3b6fde771e4044cf0dddd498bec8bb97211,75,1679638168,1679932972,ml_lstm,294804
01H65Y8T3F9BR4BB2VD7VZEPTR,did:meca:0x87015fe637da1676878117ad93ae34b1ac08db66,76,1679638943,1679803790,ml_lstm,164847
01H65Y8SQKZWHPDPAVR5BWSBJ3,did:meca:0x290b18c97c0d77a472b91321766c433fc0441a88,76,1679717838,1679729904,ml_lstm,12066
01H65Y8SXS7ZSR4GYE926R1NJD,did:meca:0xeb0aa85a7855d865e9e002d3f4bf882b619d771b,47,1679718824,1679814013,game_3d_rendering,95189
01H65Y8T5GCVE5P6QTK0RRJV6S,did:meca:0xdf07b0ec26ef28f4d7a2c093da7b639a117d7030,81,1679732504,1679970758,ml_lstm,238254
01H65Y8SW4SYFBVA2G128TRM3M,did:meca:0x90fad722f9a1b419e074b31e6e191259c2c370be,62,1679769740,1680061171,ml_lstm,291431
01H65Y8SJ44TGQ5CY5KMGMPPMN,did:meca:0x5f8d8fa893f1c7d03f626c500ce43340a1a03595,79,1679775508,1679797594,game_3d_rendering,22086
01H65Y8T63S5CFXQQMVXJVNYQ3,did:meca:0xa46bb6fe26b252a0e7f245b9080a825014e97d15,82,1679833029,1679934858,ml_lstm,101829
01H65Y8T1SK6NDN9FEEAHRQDQD,did:meca:0xe26ca3fcb9cac6dea431b8f855d58978c5e678fb,1,1679853367,1679987146,ml_lstm,133779
01H65Y8ST8R3G51H49R93SB8CS,did:meca:0xc84f149cc6ce2f9ae8d4d7aa0afcd367b63cb988,23,1679923036,1680090340,ml_lstm,167304
01H65Y8T262C3YGSBWJABT21TP,did:meca:0x9027b48af29434cba92bf5a04a99bd88ad094608,53,1679926356,1679981595,ml_lstm,55239
01H65Y8SV6CGVR5DTP399Y939R,did:meca:0x1c7a4d98439253b9ec9456ef24e2710ef55ebc56,87,1679945915,1680163663,ml_lstm,217748
01H65Y8T391P0WVPHWDKKDH61A,did:meca:0x3d0763d90ab44a0e5c2c83cab87f21e0391ea6be,29,1679964375,1680300671,ml_lstm,336296
01H65Y8SMQ2H3Y9CXYATYEESHH,did:meca:0xeaf2e5bdfb913e57c59ce619958877f94dbff23b,12,1679964505,1679975423,ml_lstm,10918
01H65Y8T449380PY5A9W6M5CAG,did:meca:0x8c3c1fa8fde088ef7aa003063f95a647adf7739e,29,1679992630,1680097958,ml_lstm,105328
01H65Y8T1BD2CDYJPPEGKSP600,did:meca:0x1909e27e6f500827af87f453f904f9ac41c0fce3,7,1680011990,1680217557,game_3d_rendering,205567
01H65Y8T1KGP8B4QJMNYZXG3FN,did:meca:0x1ea23dd521c2c1c91489de84561f58c87b260183,74,1680026002,1680102727,ml_lstm,76725
01H65Y8SR4900759VQJC94EQK1,did:meca:0xbd324bd48df32292b4b6de7434db3c0cf89bf924,38,1680030134,1680334723,game_3d_rendering,304589
01H65Y8T0D2Z1VYVNT1Q53W83M,did:meca:0x46662bdd4604d507c3fd7718f7012e8c01e131f1,92,1680050134,1680220461,ml_lstm,170327
01H65Y8T20W3GBNR7PMK85JWGR,did:meca:0xf3c080c15d20cf3154d53cf1252aca2c4d204ce0,57,1680052328,1680156129,game_3d_rendering,103801
01H65Y8SYWVFBMFV7AVM3Y4ANH,did:meca:0x85e7d418fccf6d0cda5c7318b8a5639783c7752c,50,1680059969,1680298036,ml_lstm,238067
01H65Y8SNGPT8K29GAYNSFBZAE,did:meca:0x39caad591e31f3d5d079cc50e1115564d66c409f,10,1680072327,1680469748,ml_lstm,397421
01H65Y8SWFRNJT13WYZT1GHHCE,did:meca:0x353b5618c780625a1b5559aa20f1acf930702807,60,1680088809,1680123850,ml_lstm,35041
01H65Y8SSZFBT0GAS1T947ZSDK,did:meca:0xeb87b84ef94d0001ba11963e78ea15a4d74453ba,66,1680093255,1680314008,game_3d_rendering,220753
01H65Y8T1ETHKVHPG0HVCHYHZ3,did:meca:0x30e65f4ee70529033c28ce684e6a4fb15827ad70,90,1680101738,1680147823,game_3d_rendering,46085
01H65Y8STXSRMBKBRYRX8D9TN5,did:meca:0x08c94b198061b7b5a23fdc9bf226cd4b0f5b4980,2,1680107962,1680201930,ml_lstm,93968
01H65Y8T02TV2PD9D9JHXM3Y4B,did:meca:0x0f92e68a77215466c6d1b37b2cd1b22af5b51109,53,1680147878,1680173665,ml_lstm,25787
01H65Y8SJZEZSR454T658022ZG,did:meca:0xbcdab36b294af68467c0f86f4d06d490e8e5c965,64,1680149418,1680174510,ml_lstm,25092
01H65Y8T3TR9TP2BJ12KP7QQ43,did:meca:0x86b95c29dea516909b4161fd6b3b0cce33b2d89d,47,1680164984,1680331518,ml_lstm,166534
01H65Y8SM5K8WVFDCD0GB0JG76,did:meca:0x53830bbbc8cd1db54af213e20c063c71f979b0a6,61,1680173093,1680214428,ml_lstm,41335
01H65Y8SR43BAT6J7E0QZB81SB,did:meca:0x42c063ceaf8ba7cee50fc8528d1031b19cd67b96,70,1680174619,1680454946,game_3d_rendering,280327
01H65Y8SM0V90X73JBH4T5K5J3,did:meca:0x13dab89de2c365dad1d176e35f17eebc5ee1bad8,24,1680202505,1680335617,ml_lstm,133112
01H65Y8SJYFGFJBT7CZJHP0NAA,did:meca:0xfb533537e18784da8d7632fbe8e3f9dd67c2ad7e,92,1680219192,1680277004,game_3d_rendering,57812
01H65Y8SV9KD380N1SEE4Y5PMB,did:meca:0xe0a4ce2caf443e1951f317ac1f3b5cebe60ce768,35,1680221658,1680223937,game_3d_rendering,2279
01H65Y8SW5MGGKGA64CYYE9ZE4,did:meca:0x78a18e137de994c39bff06959eea32b61df47846,69,1680231960,1680257214,ml_lstm,25254
01H65Y8SXW57BQVXH81TYNRH6A,did:meca:0x43c182ebe87f2ba7cbe3e9349068d939e559b186,62,1680239684,1680339209,ml_lstm,99525
01H65Y8SRT5M7XKJ7Q8MTC5BMZ,did:meca:0x75a1628384378621ae0e5e6efca7e44f0918a425,37,1680277372,1680493026,game_3d_rendering,215654
01H65Y8SXXJ76M4W5XADKMKWMY,did:meca:0x4bbff6f79ea67fb3a4e0dd87d2841b449af3a3f8,8,1680284342,1680501086,game_3d_rendering,216744
01H65Y8T3BGFK8MP8GQH47XGC7,did:meca:0x7d953adcc26c6e20b281c543732d0097f90945fe,64,1680284969,1680449981,ml_lstm,165012
01H65Y8SYGV6X4D5E88GQWMQ8J,did:meca:0x8734cee7451c92133c27f846b23ca796ba5dbc49,49,1680324451,1680648757,ml_lstm,324306
01H65Y8T3CE497T250HGFCDFSH,did:meca:0xabda72118753cfb002fabef7e93a75f302a4d856,83,1680336976,1680660285,game_3d_rendering,323309
01H65Y8SRFHRMPDZVTN3N2F4NE,did:meca:0xef5d7d1c38005d3b33cf05a70deae69c372f3864,93,1680342826,1680546267,game_3d_rendering,203441
01H65Y8SPBM4EPXW5RHKCZFNFG,did:meca:0xfdd07b6e5dfa9142b77da3f5afa8e0f2d4725b9c,30,1680388569,1680541760,game_3d_rendering,153191
01H65Y8T43HK5750YWVZQK9YES,did:meca:0x70af7cc87ba419d0703c1864f4d5dae14b606091,93,1680395681,1680400366,game_3d_rendering,4685
01H65Y8T4EJBXNMH82EH15KE51,did:meca:0x3fdf34f327ba4ac55f82e898747feb221d13196e,94,1680397778,1680613526,game_3d_rendering,215748
01H65Y8SRJAX0A5Z4C6A0TQPPW,did:meca:0xe2d4347bcff37c5b30ab0b5655bff7f579801a19,66,1680405038,1680658758,ml_lstm,253720
01H65Y8T608V46W1C0Y5G9MC1G,did:meca:0x2f4c8f34c791e99605b1292acca6b88868f97dcb,34,1680459630,1680621695,game_3d_rendering,162065
01H65Y8T6FZFVKDECMY9N2FR54,did:meca:0xca9bae16b019de6bd32ed5e5435351e2aaacd8cf,39,1680486843,1680699348,ml_lstm,212505
01H65Y8SXBH207WTSMZXYE4AHA,did:meca:0x5adbd6e57edb57bd89d6b0369ca5fdf6fa8def81,71,1680489570,1680522511,vr_env_rendering,32941
01H65Y8SRVZKN3KDCH2ZAEB63V,did:meca:0x23cdc8965582405db38fb90ae9635bf2febb46a9,97,1680502064,1680682267,game_3d_rendering,180203
01H65Y8T7Z1BCCK594MYS5KFPE,did:meca:0xa0cf6ca937f18ca48f6894ad2470d97ab3bbfb27,11,1680505682,1680547671,game_3d_rendering,41989
01H65Y8SYDMG5HFAYMG67CCA11,did:meca:0x8cf7db0c2c8ce58d556119e867c318dd6f552eb4,18,1680515887,1680584409,game_3d_rendering,68522
01H65Y8SRY8TTQT8A8XFCQ72QW,did:meca:0x8caad2901a182721d51e2e359a980d0c005b17b2,47,1680517647,1680709114,ml_dbn,191467
01H65Y8T4SADBJ9JH8ZFV99N8N,did:meca:0x5a8912e1289d9790943b60b3af174bc4e18aa944,80,1680534509,1680624070,game_3d_rendering,89561
01H65Y8T4KNTH68AGKV22W0FVP,did:meca:0xeb7a9bd87c802500ba9a3d1ac206f480d30a0ac9,31,1680535956,1680612975,ml_lstm,77019
01H65Y8SS2R0KSPRH7KDA6XM5D,did:meca:0x4047ec5f376c173c44c105e02a076084220d5cb4,46,1680548332,1680631908,game_3d_rendering,83576
01H65Y8SZRSQBTWW3N73PYRJFN,did:meca:0xaf6c190f411b5e7347b132c65d28a72d88aa5878,60,1680591024,1680801833,vr_env_rendering,210809
01H65Y8SPFZB799AJ9RVZJDJGG,did:meca:0xc6c44fbfa4a32b3660b88fa39fffbb155325388b,87,1680593682,1680889368,ml_lstm,295686
01H65Y8SZ09ZF6G7FPGGAXCPH9,did:meca:0x2f03d7d14623fa0ac2344c1c3ba4cfc3af8a3261,71,1680606335,1680609222,game_3d_rendering,2887
01H65Y8SMEWMMZXA7EHBCWNS7P,did:meca:0x7717c5b5441525f158404253e551af7aa0ec8823,62,1680631656,1680639745,game_3d_rendering,8089
01H65Y8SRJH2FFXZ9RHAPJ2GKV,did:meca:0x2f62d5831153e5997f99e497d00f4b993de74b14,48,1680679243,1680756514,ml_lstm,77271
01H65Y8T1D4Y6SMK0KPW8R5V0H,did:meca:0x92c72b3497bbedfdc62136aff9915706790648d6,45,1680694473,1680717340,ml_lstm,22867
01H65Y8SRD0JMN7TC84RR6YAEM,did:meca:0x21ecf0a3fc7401638dda6dd10b4f3f2df0d78664,79,1680701656,1680767167,ml_lstm,65511
01H65Y8T6GGN7111JFJ72FAFKM,did:meca:0x7eab94bf147e8a4624c9fe6569cb8749167e1107,76,1680710353,1680911143,game_3d_rendering,200790
01H65Y8T6KNXMA8FZDPFS1FZF9,did:meca:0x7341bdcbc0936ac2d6ac7590e83b89dbabc13010,27,1680722936,1680759978,ml_lstm,37042
01H65Y8SQHNX2M3F7BRDQT2QKC,did:meca:0x17d11059fdf63298b53686e8729067403fb00230,91,1680725482,1680749805,vr_env_rendering,24323
01H65Y8T3JNJPMZ582Z2NVVJGH,did:meca:0x2d159b9db7b87dcd5e2629ec4abda316a024bbe8,11,1680750885,1680763744,ml_lstm,12859
01H65Y8T3VGHJQMX70M0J2SRWB,did:meca:0xfb35484e237936be9c4f0bba2ae448f36af65fda,92,1680754479,1680755420,game_3d_rendering,941
01H65Y8SRHJWVSW3FM0AJ8ZS5Q,did:meca:0xdc2f115037bdd34baf6d7bad292777c7c5fcf885,90,1680776110,1681093037,game_3d_rendering,316927
01H65Y8SV8PE8AVM936FAWNF89,did:meca:0x3449d024e1c22f1fffd696bf56c127d0b54dd11d,98,1680777854,1680785749,game_3d_rendering,7895
01H65Y8SRA2R776JTS0PQHXE7A,did:meca:0xe86de30b6620942bc7c520430779bdbdd2484c39,87,1680794990,1680999598,game_3d_rendering,204608
01H65Y8SVN5ZM648RDT93N59AT,did:meca:0x44216ba199a266618b675dbbeee671e739f80cf0,65,1680813638,1680904236,ml_lstm,90598
01H65Y8SZPRP3QWXH1BD44H7KQ,did:meca:0xe4b9867ba3bbb39641968938461040c7482f96ef,79,1680816758,1680943674,ml_lstm,126916
01H65Y8SXXXPBP760TC3T3QN7W,did:meca:0xc73d6492680513adfc125b2a879a567f4f1c888f,7,1680876119,1681082943,ml_lstm,206824
01H65Y8T6F7G4PR52ZP25DGZF4,did:meca:0x5d48ae28a7bdd074bff6c7a16fd7984608aba7d2,15,1680877300,1680909708,game_3d_rendering,32408
01H65Y8SM43VPRJ34FB6A8BWFQ,did:meca:0xa184eb8c5de47137267f31515fc9e5b08bfed6f3,50,1680889482,1680929177,game_3d_rendering,39695
01H65Y8SQD4E433ES6FW7Q1EEE,did:meca:0x9b82e1cf22efe1e21ab5731afa99d46953ab0159,47,1680912257,1680920876,vr_env_rendering,8619
01H65Y8SX00CHGH44MHPS9WEZR,did:meca:0x87a2521bbe2f201dc03f8151e874f046033d2150,9,1680945373,1680956782,ml_lstm,11409
01H65Y8SSRSZ9T1MJGE3XTAJSQ,did:meca:0x2684cd9fa07da8a20e185ec2e30d50c8d778a56a,14,1680967102,1680980295,ml_lstm,13193
01H65Y8SNK3JQCX5R0EKQ9M8AC,did:meca:0x7ab0c567a64297051303a4c6a2c9dc4699eb708c,80,1680978144,1681266250,ml_lstm,288106
01H65Y8SP35XN1XASN2KY9W8YQ,did:meca:0xc08c9f4f8f66413b169cbbb637cbc6ff8217c96f,67,1680992860,1681182104,game_3d_rendering,189244
01H65Y8T7A6NGS9YY1P7AN2J4N,did:meca:0x28974ff1392d05b4b0abb0765dc22923b7dbdc50,26,1680996720,1681095774,vr_env_rendering,99054
01H65Y8T573CARXSJWXFQBNPP4,did:meca:0xe76f19271ea7a3bfa406afff428a097cef75ee3e,52,1681019182,1681118623,game_3d_rendering,99441
01H65Y8T2848R65G32G8G0F0DR,did:meca:0x6e990ec6827d4247bc1d9ce42e444286f8810369,33,1681025455,1681222464,game_3d_rendering,197009
01H65Y8SW62F48D5YKBWMQ9GHA,did:meca:0x0414fa28117d345fa153dcf7f42ede0319ecea06,30,1681028076,1681102695,game_3d_rendering,74619
01H65Y8T1ZN37DMFKYGHD6XVZ3,did:meca:0x9dbf226c2c3dc5c059e4d3ce1163b2ce038f3c85,68,1681051036,1681247135,ml_lstm,196099
01H65Y8T51N8Z2BJ6NG1HZV35W,did:meca:0xc1c40613af5b9d39e5b5b713772b93d1f13f4ade,95,1681056825,1681252595,game_3d_rendering,195770
01H65Y8SWJR7TZ7WA6ZNCX331X,did:meca:0x44a5fc800c6eba08747e7c6394b6b2b8907969c0,9,1681080348,1681133409,ml_lstm,53061
01H65Y8T7WXHXFKQG15ECHKM6Z,did:meca:0x66ce52266ddbd4be37f43be473bd2f73e9a22a97,24,1681082298,1681111947,game_3d_rendering,29649
01H65Y8SRWVJQEAP3HZ38REPXG,did:meca:0xe5b65f36e5e9682946f9443ec9196d61a34a7f6e,56,1681086525,1681232022,vr_env_rendering,145497
01H65Y8SNDZDA8H2BHWG73QMXG,did:meca:0x2e66584f0a9a5c37f1224dc776ac13f370ce6aac,1,1681103482,1681344598,ml_lstm,241116
01H65Y8SRM55ZEN9DME9CQWTZX,did:meca:0x2d9ea6245c7cfeb39608f95d3df31d0020fddd02,96,1681110011,1681504544,game_3d_rendering,394533
01H65Y8SQWM7B4YXS2X89SQHMK,did:meca:0x4bef9fbc36c2b0128c2d76f161eab8a002d09ab2,38,1681138008,1681397830,ml_dbn,259822
01H65Y8SSMRD7AB5YZ4WE8NF5T,did:meca:0xd53b1da1912aa9ecec2bce5c97d8242ae422a5b1,63,1681147084,1681411050,game_3d_rendering,263966
01H65Y8SQYQ1XRF1BGQ9CEGTWS,did:meca:0xeb89dd82dd1cce9bedcf968603eccee4f22b64a2,73,1681158270,1681306424,ml_lstm,148154
01H65Y8SRYN2AMM7X21JY29KRW,did:meca:0x93d463c2fe9adf522a636b29723de9faaf379a52,1,1681159037,1681212503,ml_lstm,53466
01H65Y8SP5TAVMC1NTRM0KMDWG,did:meca:0xf9cb2b215330336b97e7b05d9c9e8ed94be353e7,88,1681193893,1681195335,ml_lstm,1442
01H65Y8SQSSCVJDVM6GJFSH9DF,did:meca:0x055a811169e137c82df2f4328b3c9557e2fc755c,42,1681195256,1681680717,vr_env_rendering,485461
01H65Y8T0NVC64RQ5H329KPZN6,did:meca:0x2ad55cffb93f5fd4e6b3dc5c287bd0c309f59201,37,1681254336,1681392799,ml_lstm,138463
01H65Y8T6SM048KTJEA26WFS4Q,did:meca:0xf2f78e0d2631e3f922f65877393d9d70f0f54c1a,2,1681261912,1681424700,ml_lstm,162788
01H65Y8SK6BGQ74E26E9DZQ2DG,did:meca:0x30c6ddd9ea544bcf6b105662b7f40a67b3a08858,14,1681277636,1681359426,game_3d_rendering,81790
01H65Y8T10SWY1FSME9HXNV45H,did:meca:0xbd1a9ba0bd1b440a6ca8687fc1129e0001f4e8f8,4,1681280998,1681350022,game_3d_rendering,69024
01H65Y8T79BS3TZ5N6SW30TC14,did:meca:0x2ed13f17162e24f06daa2b5febd4140b97570533,52,1681284614,1681352815,vr_env_rendering,68201
01H65Y8T018YTCHYDM045B0SFP,did:meca:0x0e11a2192a9cccf64b44101a47d855a365e3b709,98,1681402567,1681765750,game_3d_rendering,363183
01H65Y8SMSCAH37NE3QN2KZ736,did:meca:0xb617f343a911d11505d7c25463ad08a940d046b2,13,1681404883,1681563838,ml_dbn,158955
01H65Y8SKJ92FVWSPWERDEG4MX,did:meca:0x7eb8c2bd67fb75ab9f9a6b98d123af12674c92ec,28,1681409584,1681524220,game_3d_rendering,114636
01H65Y8SKKYSJ0AYNAE8SXP8EQ,did:meca:0xee917c818bc5538f9571dc074c9eca05ef77747e,43,1681441473,1681903440,ml_lstm,461967
01H65Y8T57EKB19DYZ9NTTR5HQ,did:meca:0xa7c74a523daa99ba1e4a817b9a8b3832fa22d7e3,93,1681521442,1681580807,ml_lstm,59365
01H65Y8SXP6HYFA7FVGK82YAGP,did:meca:0xa4609e26a73561b861c50b8614a4faf4b3235a96,93,1681523845,1682022180,game_3d_rendering,498335
01H65Y8SN98DP9C2NAB9KT5EGE,did:meca:0xa259b1d219966be05f133fb0ceba8f0f054c3caf,65,1681523906,1681541451,ml_lstm,17545
01H65Y8SNY8TB5QAV7BHT2JCXB,did:meca:0x14aee5c548cab4d7ab9884a8b26fa697f40ba197,35,1681525118,1681739933,game_3d_rendering,214815
01H65Y8SJPTZ9Q7ZY0B6ZG5JBC,did:meca:0x835d64c153ed28bfc317b4c01cdaab19033d0d9f,61,1681561624,1681573870,vr_env_rendering,12246
01H65Y8SP6ZPWX29F721HXZPX7,did:meca:0x154e24f0f011e4c3ee4dcc2a581266b8c39e0efc,6,1681563244,1681740626,ml_lstm,177382
01H65Y8T3HES1T1QYJCD1X0M4N,did:meca:0x52784f0ced7abf004196e8261b265a0db84ba7c4,77,1681575129,1681622648,ml_lstm,47519
01H65Y8SM8H0W88A4X48GMNTSM,did:meca:0x6a9fbced301419b94caf8f9d9040bb2e9f682386,26,1681604378,1681641140,ml_lstm,36762
01H65Y8SKM9DMW2ZXQFAF0ET60,did:meca:0x9c0fc36af7750fefb2375fd7a6a01e325bf6aa86,38,1681611935,1681758947,game_3d_rendering,147012
01H65Y8T4B1H8874K66KGQ0K73,did:meca:0xb638e13577c4536d61385ad6155c6cc4d96c09e4,31,1681612029,1681702877,ml_lstm,90848
01H65Y8SWWK8Y2QSW7RTVT8NYV,did:meca:0x5cbe670080c6c8e48140cd935c2e18e56339dc4e,61,1681612997,1681686307,ml_lstm,73310
01H65Y8T1FBX49V4W7BSW9CB6K,did:meca:0x74cfcdd7fcff36299ec1a46dddcae69cfedee451,28,1681617245,1681777132,ml_lstm,159887
01H65Y8T1RCKBXSKNX55PX4V17,did:meca:0xa2ea5acbf67c87418dca82f51053589befa573cb,97,1681656125,1681732866,ml_lstm,76741
01H65Y8SJJRQE00V54SRE6CBSE,did:meca:0xe09cf7ac787f2d80ec2c54738c1f4813ead0e361,91,1681668525,1681783629,game_3d_rendering,115104
01H65Y8T03S2BSA93T02W8M9ZZ,did:meca:0xaab946e9ae378929cb06888284e46b454857d32f,28,1681678210,1681780750,game_3d_rendering,102540
01H65Y8T304EQGKMMJ5GSNGNBG,did:meca:0xc0b0bc952056187c0a98720043a3a12c7320e19e,25,1681688956,1681856136,game_3d_rendering,167180
01H65Y8T3V3NNGM1C3F53PMCZ6,did:meca:0x55edd15510adbbd6cf6d3287077ba8ffc24c9567,79,1681700893,1681740682,ml_lstm,39789
01H65Y8SYPVSZHDSP13RCH1ZSJ,did:meca:0x604fea86b5e03f1250d8ba6dd12b1a8c97315bfe,8,1681712068,1681979558,game_3d_rendering,267490
01H65Y8T2NDXCM0CKSMQ1ME200,did:meca:0xdd59b9be94dced89bf42b210e58fcb17a037127c,2,1681727472,1681843377,ml_lstm,115905
01H65Y8SJH7YW53ARG1DGA37AW,did:meca:0x3e3c3708e1799a08f8d9b4b56a0fdaf3452d91d8,77,1681741791,1681752906,game_3d_rendering,11115
01H65Y8SVVTMB2ZVGTNG85QXDR,did:meca:0xf7b654c5de894f2aea70a1c61c5f65527c659753,56,1681749417,1681919162,ml_lstm,169745
01H65Y8SWSDXK1KXPX7SMY1SJZ,did:meca:0xbf52923cfa93dd455997bdb4c9ccb2155a222134,32,1681788968,1681884210,ml_lstm,95242
01H65Y8T6H6RECHNPKMCX07K8M,did:meca:0x81508bca5f55b87fb0fc6f74eac44fc461743ab2,93,1681809769,1681946182,ml_lstm,136413
01H65Y8SW46S8E3ED4WCHE53Q5,did:meca:0x1d05b7f918e491e3a9190884ec4c5341e4ed3155,90,1681833575,1681989131,game_3d_rendering,155556
01H65Y8T5P1RDCZKTP1Q8RDQWW,did:meca:0x62ebf300ac64480c3c97fb9e293fa8f78ff2ff78,89,1681854504,1681927507,game_3d_rendering,73003
01H65Y8SYHXMG55K54KTHDDK5Y,did:meca:0x20a069fb43f66ead616d4371cdcb9e67f94fce54,26,1681880585,1682137068,ml_lstm,256483
01H65Y8T42CXM5SPDPXERX69HT,did:meca:0x19e29a967b0d064c5c388ce81d9c12dbe2244e72,76,1681885859,1681908216,game_3d_rendering,22357
01H65Y8T4JVKJV91K144GTRK95,did:meca:0xa0ab42ffd4c6ff70b85c91d2bc1f428328a03af8,93,1681893695,1681991548,ml_lstm,97853
01H65Y8SRR16CYCWB77KXZHYQ1,did:meca:0xf03a6ea5ca9531b721d2a7b3bc787674ea31b433,6,1681913906,1682002054,ml_lstm,88148
01H65Y8SY3RKBE9DA46934CRQT,did:meca:0x2d2034ee36be135fa7411492e52ac5ff0b864ad7,65,1681932878,1682147304,ml_lstm,214426
01H65Y8T1JQNZPMG9G0D55SYBZ,did:meca:0x6d6af614269037b706fb5e74d77d361917c33f57,29,1681937210,1682046458,ml_lstm,109248
01H65Y8T2F9Q89YQ78SK0TAPH7,did:meca:0xba41d84b260f759e744d4017ce0679f8a85d4324,7,1681943487,1682056476,ml_lstm,112989
01H65Y8T0H3T0NPS2NM65M779K,did:meca:0x6acd6cad8657f1071748d2ebdbc33cf087b175c4,90,1681954435,1681985525,game_3d_rendering,31090
01H65Y8SYDJKF657PX217DEBB1,did:meca:0xb8be52370010ee58014d41e4cc495e5bdee3743a,21,1681990787,1682225803,game_3d_rendering,235016
01H65Y8T6T977P4QTTDTA8KA4J,did:meca:0xafc31f879674f4a1ace444d824d95ec07181c545,29,1682024751,1682184842,game_3d_rendering,160091
01H65Y8T55WHWXAXB1HG8W4S1Z,did:meca:0xa2b3e7c7ca31d1ff4dce3c6319c42e2048dc59ad,22,1682027554,1682223309,ml_lstm,195755
01H65Y8SVKHGD0AKRWHDEN2V4T,did:meca:0x20e8cbf7ce8660b7be703268d8548e3e47da239d,47,1682030888,1682090159,ml_lstm,59271
01H65Y8SNDGE9BKXTJQCCCETGY,did:meca:0xe1bd46e92dfe8cfed47c896d5ab3f113b7e61b90,54,1682048201,1682280883,game_3d_rendering,232682
01H65Y8T370565ZS1SJB11CDN0,did:meca:0x12169586410e7e0571f8491e3cb8ea79aa05e562,89,1682097088,1682273891,game_3d_rendering,176803
01H65Y8SVV0Z2YVTYX0M8MHPX1,did:meca:0xb213068a45a00114bc9268044f4489e73a9e22e0,68,1682098273,1682194299,game_3d_rendering,96026
01H65Y8T50RR9BWQBR0STT98NP,did:meca:0x564459e5cb84c015d4c3f9d1115f92d4a357136c,20,1682102133,1682243166,ml_lstm,141033
01H65Y8SJWXK3459WCDXM6W5MD,did:meca:0x17efffddf74cdba607c1d8a599bd34242626a093,66,1682118155,1682195396,game_3d_rendering,77241
01H65Y8T2BB5N46DY720ZZQMKA,did:meca:0x06012eaa2989f54ee7737344ceffa5f04fe87437,4,1682133379,1682202840,game_3d_rendering,69461
01H65Y8T5ETH1TASAAANTNW8CK,did:meca:0x65e56cae6aa8715d553203ffd61265961673f7f9,72,1682146981,1682535130,game_3d_rendering,388149
01H65Y8T173VJZBP2SCTBRYXBV,did:meca:0x3732efc9c7b4d323865f44e07d14f7ac9cff4332,18,1682160676,1682182761,game_3d_rendering,22085
01H65Y8T4WFEV2VK1NMGVJTG2Z,did:meca:0x76652bc6a734594199985249e9bc2272266229be,94,1682181483,1682295392,game_3d_rendering,113909
01H65Y8T0CGH8P7MWJ6YDWPJ38,did:meca:0x14abf4ab4a6315bbeba0728237ab27df08dedbd7,38,1682199690,1682460896,ml_lstm,261206
01H65Y8SKDMPE5861ZHG58GHG3,did:meca:0x6a7811818de9a4b213b4dabe6be794f9c4e9a339,40,1682202015,1682388551,ml_lstm,186536
01H65Y8SSYFNHZYG7F1FKE2WFS,did:meca:0x8c52a9d3dd09607fb24da0d4923d9e48ff6ab1e4,4,1682204939,1682205832,game_3d_rendering,893
01H65Y8SKR4Z28XJJ8M6KPNMGR,did:meca:0x02b583482f7d11602d74e5ccecb5094947855d5a,69,1682215400,1682379833,ml_lstm,164433
01H65Y8T7ECAFB1BVRT8BZ0GBB,did:meca:0x1a6755d3b3fe8517f9e776540b9c110c67e89324,32,1682229077,1682286974,game_3d_rendering,57897
01H65Y8SS4EGF46QV3GJJZ9QJX,did:meca:0x2ef9667e27f686b1a8ff6aed8dfc62dce26791a7,41,1682229432,1682469972,game_3d_rendering,240540
01H65Y8SSG7BHDAX3RVW2C5RZ4,did:meca:0x86d47af26800293b2d6d16cf02487613d269a8bd,10,1682249600,1682486770,ml_lstm,237170
01H65Y8SP1DH9PV650301ZWRYQ,did:meca:0xf5d009e575663bdcc5f63f6299f3551567408b08,98,1682256826,1682424049,game_3d_rendering,167223
01H65Y8T7K4NXHHP2GSFCPM5EH,did:meca:0xd1782f0953a16d86dbfec34ea845268ae29249ae,85,1682257615,1682480596,game_3d_rendering,222981
01H65Y8SPCFGN0Y8QJRFPY9ECP,did:meca:0x7cca52d6ede52965ab9246e1beea36c24cf88d66,25,1682264086,1682571220,ml_lstm,307134
01H65Y8T2T9362QN3JHQTPWEEH,did:meca:0xeb6ca59ec2072965b24266f14015fe0db49c509f,3,1682280254,1682289560,ml_lstm,9306
01H65Y8T3QMQ3VTEQKAF5N4HGG,did:meca:0x882943d6f443f71d36e188729c7a66afc30a3091,46,1682282984,1682447835,game_3d_rendering,164851
01H65Y8T2C2XEVJC17HV902BG3,did:meca:0xc15238a740e2dc9dab2fb15428e13a2dcb0ec703,1,1682285425,1682382886,ml_lstm,97461
01H65Y8T7QPNJN47DBB9Q654RJ,did:meca:0x8816639a2e49114066ad033b50e454ccccab0f55,85,1682311159,1682346342,game_3d_rendering,35183
01H65Y8SK04STR7X6WTJH7R767,did:meca:0x67c4ff2d32d833ee55f5965705abaa766b3d946a,21,1682319122,1682434638,ml_lstm,115516
01H65Y8SW10SDBZ14RV5KC7G01,did:meca:0xacfe8bed45268ca24afa5420b487bb9fd1278494,2,1682329968,1682419478,game_3d_rendering,89510
01H65Y8SRXA0Y5PXP690CQKKV9,did:meca:0x9f3c3165e073987435270efd7b4ac6ac7727d24f,76,1682352714,1682373654,game_3d_rendering,20940
01H65Y8T0ANBSZXZ5VW665PNXA,did:meca:0x64e5670b467e2d8528b5b50812700c5240582fe8,77,1682377370,1682444280,game_3d_rendering,66910
01H65Y8SPA8DJQ37ZSSF265HAD,did:meca:0x3cbc1b444c9e2440bf7871e48f17ebbeceb1951e,27,1682394505,1682403343,game_3d_rendering,8838
01H65Y8SYNFPXQ0R416J37Y1VA,did:meca:0x90f66cfe12e3254c07633d02e020063d4ad1ee1e,52,1682407549,1682708238,vr_env_rendering,300689
01H65Y8SY88T29DGMHCFAVH9MP,did:meca:0xca92450389a774579abe4a6e7a0587b266a37a6b,14,1682408016,1682411597,game_3d_rendering,3581
01H65Y8SJKMRFHRR4EP33HF0DQ,did:meca:0x03ae176351ee7372cdd5c32720504850e7b73112,60,1682436017,1682502068,game_3d_rendering,66051
01H65Y8SR9HYNVAVTHJDACY7V5,did:meca:0x707458eaf99c6d7304584bde490ec5dee24191fb,100,1682439145,1682502826,vr_env_rendering,63681
01H65Y8SP4AN0BXQ0B2SSE7ZWF,did:meca:0xd4eb4781c2ab290b8cfbb0f890c2034f05f0a0ac,11,1682455823,1682618249,game_3d_rendering,162426
01H65Y8SQ4GV9CT3JRPNG973MX,did:meca:0x4f5c5ffca26e1883f5b620c0b0f7d8ad4679df4c,53,1682482781,1682529899,ml_lstm,47118
01H65Y8SRCPH2HK5M0V7WY5W88,did:meca:0xea843c415c1bb5946b495f8986e3a29ee900a791,4,1682546879,1682791277,game_3d_rendering,244398
01H65Y8SWRSGNYB354VJ1BVJTH,did:meca:0x13529b991bc8900f61425d5c48c4c463237ff8aa,48,1682579340,1682625552,vr_env_rendering,46212
01H65Y8SN293M68W4SX30422E8,did:meca:0x7fedd401d68316b5dc07d0a353b987ad3abdcb99,56,1682581764,1682626563,game_3d_rendering,44799
01H65Y8SXBH623G9HZYQ13W9MP,did:meca:0x7dc831d77862a6270f110ff6495c4af747d8c2af,34,1682613025,1682738700,game_3d_rendering,125675
01H65Y8SZWZDQJEJST8D3W2HE1,did:meca:0xc189db05af2dc591c2dbb552e8e92a9de83da530,67,1682620575,1682781604,ml_lstm,161029
01H65Y8T5CVHWRK4NP7EEAA8ND,did:meca:0x51d5dffbbf2a8912aac016a61bef91cb3f2de51c,38,1682624712,1682768726,ml_lstm,144014
01H65Y8T5ZJZAG5WTKZDGD8XPP,did:meca:0x3bf71860a1fbfd434136a33e4c259dd68fcc11c0,88,1682625398,1682673356,game_3d_rendering,47958
01H65Y8SYMKXD1ZT4ZMDZB9Z5E,did:meca:0x4ea2e6e9d5c4fc5f589c7e4c2deaa2392e32298e,67,1682634103,1682804460,ml_lstm,170357
01H65Y8SWJ7E5PXYRERARVDKHE,did:meca:0x31a6bb35df9e018693750d9c5f47c3d63e08c723,4,1682641962,1682863075,game_3d_rendering,221113
01H65Y8SJJ786EK1S407G13HER,did:meca:0x7a7feeee242802952a822ddaea1e8df069361890,25,1682686871,1682706028,ml_lstm,19157
01H65Y8SVBBQFW8DC20RJM4PZJ,did:meca:0x193526fc5975a3e3c88217cfbc07f0661b93dc21,81,1682692236,1682780673,game_3d_rendering,88437
01H65Y8SX65Y4G3E5R1T6Z0P8S,did:meca:0x4652e9681943d8725970261a714bfceb6f0d61a4,26,1682710250,1682873133,game_3d_rendering,162883
01H65Y8SYBA1358Y15DG8JYTN7,did:meca:0xaee2d65190becb1d8091b9ac09bc5522189a6d24,75,1682741211,1683001630,game_3d_rendering,260419
01H65Y8SNPPH9FQR12X3K0SQJT,did:meca:0xaa5e1ba5908d03eda71cc7c233de0bd52c3ad618,34,1682820324,1682851905,game_3d_rendering,31581
01H65Y8SJ5YFEG6FG8SD043XK3,did:meca:0x09713e0d0246d889ed952f41004501e9512906c3,49,1682840963,1682979546,ml_lstm,138583
01H65Y8SRBXJ1197HQ6PPVF8DC,did:meca:0x68d4a0ec3836a654565475d1f702eb1dc7d5447d,68,1682851489,1683191586,game_3d_rendering,340097
01H65Y8T3MDE17NET8XW5BRY84,did:meca:0xfef41b11e5aa4afd3f749c3221486f62fba746c2,11,1682862958,1683111453,ml_lstm,248495
01H65Y8SRS0AZKDBA6TG971TE8,did:meca:0x2d0957e6da37b99e39e67af71bfc6492ea2c55df,35,1682889142,1682940747,game_3d_rendering,51605
01H65Y8SJB496VV0YMFG0CQCQR,did:meca:0x331f4fa01803ed4e59530896ae27900af48c2113,61,1682889256,1682943680,game_3d_rendering,54424
01H65Y8SQ7B6YCJAZR4NY3KW7E,did:meca:0x0b44a8e6d4b3a4432fe8478e85468fccb7c42733,99,1682890939,1682899319,ml_lstm,8380
01H65Y8SRKQ3YGCHTT8M78EYMW,did:meca:0x45238abed6054fed3e91c626315733c745fe9ae7,15,1682962766,1682990196,ml_dbn,27430
01H65Y8T44VT330P803VS6924T,did:meca:0x85fd22f36e7d5c4fd25d282181e30b878614aefa,2,1682995079,1683074314,game_3d_rendering,79235
01H65Y8SPM0CTJ1P0YKH1TKE65,did:meca:0xea66ea92f38d91802aff5f09a85cd345e2a65d4d,79,1683013373,1683236888,ml_lstm,223515
01H65Y8T2MGBFQNWTDB83HG2FM,did:meca:0xe78f807bb725663b69958c85a472e558aa1c3455,64,1683064439,1683234915,game_3d_rendering,170476
01H65Y8SQZ6YES594YYXHR9RMW,did:meca:0xd5e2b454bb9a972ea604f4b5814ef31f91428250,47,1683096554,1683175224,vr_env_rendering,78670
01H65Y8SV2R8K9BDQHQTZMX1S1,did:meca:0xc9845dc1c2d255b6229442e3e0a14caa497301cd,33,1683100439,1683361144,ml_lstm,260705
01H65Y8T7W5A57R13MFY4AV4EQ,did:meca:0xb31c4a01b39eea0a98aebc90cc6aa79dce13c6b9,42,1683109076,1683245208,ml_lstm,136132
01H65Y8SMJ35C4X5SA615THBY0,did:meca:0x31e99951595e28d1302dfe607a807efaeac8d7ac,87,1683129648,1683228728,ml_lstm,99080
01H65Y8T66306A8MMQ8KJGHT0P,did:meca:0x1e5ed19076823f4f5fd32f66f406bb251c9e6fab,29,1683134398,1683391783,ml_lstm,257385
01H65Y8SMN7K6EQYDFB83XTJWB,did:meca:0x743b02e522a640ed17d2c17af3ee7b0a0e430c03,72,1683177673,1683342316,game_3d_rendering,164643
01H65Y8T2J15QCR6SEP61JHCSZ,did:meca:0x0432bb89bc719a115c16eb055ae9a58c4322fe4a,19,1683192533,1683370739,ml_lstm,178206
01H65Y8SPHQBRPQHCABJ837Q1G,did:meca:0x03fd638669ad9aa80d2f2f2169e41bf7d2a65523,31,1683244045,1683333608,ml_lstm,89563
01H65Y8T5AP612K8PQ9G7WNESW,did:meca:0x4fe3f0db566849abb79738a5c9092c7e5c5b1f29,45,1683286421,1683428091,game_3d_rendering,141670
01H65Y8T78CRN1A3CFGA8ZVKEW,did:meca:0x8c99f3eb57d7053134ab5028d7dc48e0c7d0f212,29,1683291944,1683362246,game_3d_rendering,70302
01H65Y8T0JRKC4VQ33097XYMY3,did:meca:0xc65cf4fa0ec60ffeb765a5d8e9ca669f14afc4de,35,1683298961,1683357019,ml_lstm,58058
01H65Y8SWXN3V0C3G0X2QYPGX6,did:meca:0xb0dfa926c35a2f295ea9edb2c71c40d8db86763e,42,1683306472,1683406220,ml_lstm,99748
01H65Y8SQND9C9F3XD0FHTTNJ1,did:meca:0x811ee959e39f2e83e0f383610f4965a352ee1194,18,1683322923,1683604698,ml_lstm,281775
01H65Y8T6K12R4NCM4AXS5D8M0,did:meca:0xe2499c88a4f902d7e31b7c7d5f32cdb11504b6f9,98,1683363102,1683491007,ml_lstm,127905
01H65Y8SK5D603PVQA102VKH9E,did:meca:0x98a7e6d4b79fea2953b6d671a7f3e9ace55ef50a,47,1683406897,1683885553,game_3d_rendering,478656
01H65Y8SV1268SWYGFQA75Y100,did:meca:0xafc137ed2003ae3f91262243983a02b35a04de6f,55,1683453974,1683607859,ml_lstm,153885
01H65Y8T822JF1FT5AR179GKQP,did:meca:0xd973698d823d70c225a823be127e69de6dbb8f2c,11,1683533264,1683634285,ml_lstm,101021
01H65Y8T0TH8NQJ16JHF2KGAZH,did:meca:0xe6a9620e6c80549d51c03eca77dffb3d932d679e,40,1683543615,1683700083,ml_lstm,156468
01H65Y8SQ54NZ0V0WTNYMEAMHX,did:meca:0xe9d609d2c5a7be731b92885a864a23c39bea202f,87,1683582732,1683647583,ml_lstm,64851
01H65Y8SMGP7JQ0BKA5KKHWW4T,did:meca:0x3abc93891033a2210236f7674a743da0ab3a1c2c,22,1683592080,1683595495,game_3d_rendering,3415
01H65Y8SK11Y30DDTBR29FMNYD,did:meca:0x3711165bf35601b5d497ed66c41dc0be7aca2e64,94,1683608779,1683683717,game_3d_rendering,74938
01H65Y8T5S8951QRSFC67RKDEH,did:meca:0x88cc44ca9e9d720a54fee8f6bd6151ee067396e6,62,1683621071,1683752571,ml_lstm,131500
01H65Y8T55Z624T003VN8FRNW8,did:meca:0x61df94db2ad4a9287b9f403bd640e53e21672616,46,1683631354,1683654038,ml_lstm,22684
01H65Y8SNR6YBWYN87Q6503RD4,did:meca:0xc111eedf9ee6360ea019602eb96f83fdfad7478c,79,1683656681,1683751789,ml_lstm,95108
01H65Y8T2RN4E0JD3XDCDCGW7J,did:meca:0x469ec2598a17c1230896b705453530bb3aa36090,97,1683659596,1683987605,ml_dbn,328009
01H65Y8SQFWVC8EK83S789S1CS,did:meca:0x80e7bfc97b2e5ad7cb3cd2e177b0a51fd7f13e60,55,1683666168,1683727378,ml_lstm,61210
01H65Y8SP9XRFVR0VT4511FBD1,did:meca:0x130749ced1f28701b8c11291b1fd10838ccad515,81,1683666348,1683838452,ml_lstm,172104
01H65Y8SJKPV9TVEZEB3H2FVB8,did:meca:0x43a3f08c3b39a101dd075adbe982860776e96e42,62,1683752854,1683837357,vr_env_rendering,84503
01H65Y8T79ZT6W6DGBH8H6CVD0,did:meca:0xb9281abfb7a84e91da1e34e1e9e80820f8f27bbc,63,1683793070,1684079867,game_3d_rendering,286797
01H65Y8SP7WX4729NVTRV03CR1,did:meca:0xd4b7be80101767e4dd23f3700d66db3c1eeb57f3,42,1683834282,1683883980,game_3d_rendering,49698
01H65Y8SYJWS4JMD0XF9TPHWYB,did:meca:0x75e4cd434466869b229cce9f7a1d8bcc5a992159,84,1683836033,1683984524,vr_env_rendering,148491
01H65Y8SMFXPP733Q5XHG99FEB,did:meca:0x90802c1d36b94eeb79579dbec12689332ba55705,69,1683853471,1683882757,ml_lstm,29286
01H65Y8SJ6S3NK8QTP93C2VRMR,did:meca:0xe89296671abdf5b957e1a359da5ed18c981b4147,45,1683863980,1684152274,ml_lstm,288294
01H65Y8SZ5W4AABDYQQDM0SMMQ,did:meca:0xd6aa6965d67eef7aed4c2d4188f6e2117aa6a009,93,1683867057,1684030153,ml_lstm,163096
01H65Y8SZT24PT617GMKDHEFCG,did:meca:0x962668c526dfbd51c02dd9e7bae26e5efce7b8a9,18,1683906703,1684029657,game_3d_rendering,122954
01H65Y8SNA4F45AV1Z5EDP3P4H,did:meca:0x2e934c68662a01ed8b05ed783dc129ae7a40d12d,91,1683907055,1683929325,ml_lstm,22270
01H65Y8SNHBY8VTHJZAM7SCJ6X,did:meca:0x437f8f61823b89fec9d60d314c1ac9cba922d63f,58,1683954717,1684312500,ml_lstm,357783
01H65Y8T11Z8ZTNGC232XQ0EG3,did:meca:0xf43b1b7559a5cb44be99f674c8432d2d1e2e4ba0,24,1683962842,1683994970,ml_lstm,32128
01H65Y8T40Y1ESR8ETZXTBC210,did:meca:0x6853f8beb3e75de0f3f2d16945f9a3cdac74d764,13,1683987351,1683992301,ml_lstm,4950
01H65Y8T5W99ESR6TH1P55853Z,did:meca:0x6cd75ef4640f12c076fcea5ad6ccd0d81e6231e0,19,1683989731,1684217402,game_3d_rendering,227671
01H65Y8SZ8TBHRXK48WAB26F2V,did:meca:0x7272bc4ea33fadb8ded299837d2034d3d9fcc153,70,1683995702,1684058980,game_3d_rendering,63278
01H65Y8SJP3KSXDGAZGA4ANM9D,did:meca:0x8496deb9b36b826d9b24f7058b9b4c14e81eef5c,32,1684007363,1684023680,ml_lstm,16317
01H65Y8SQRHXQDTA6ZDDHJJJSC,did:meca:0x2f073a4696bc53535b1dd3671eef74568e35c35e,23,1684015168,1684196833,ml_lstm,181665
01H65Y8T22V7373RBM754SXBNM,did:meca:0x477871e8fbd889349b9c3776c6b30c3b8e94ca51,4,1684033533,1684128053,game_3d_rendering,94520
01H65Y8T4N2MWKE0J93NF9CD76,did:meca:0x57d229b79d066b941a044322a8f127fbf28e1e49,14,1684040468,1684066711,game_3d_rendering,26243
01H65Y8SXZ31QE0TNW1XPAYG8Y,did:meca:0xf056829cc76c4f2725358088a6ac5cac7cb15518,55,1684043846,1684286907,game_3d_rendering,243061
01H65Y8SKERKZRC4T5AYZQCWWF,did:meca:0xafaf62a9e3c340fc2970a3f4ee0a7a0d4369ad07,98,1684044421,1684207069,ml_lstm,162648
01H65Y8SKY65E9JQN4DSGESVK8,did:meca:0x21c2993676e8488c1ca8a12badb7fbda40dcaacb,26,1684050491,1684309042,ml_lstm,258551
01H65Y8SXTK57W0B6G9BV1B00E,did:meca:0xa0ff6d1b5706a24bb46875462c26dbd3220745ed,66,1684065506,1684189196,ml_lstm,123690
01H65Y8T3QDNWS1X9JPF0XM9H1,did:meca:0xc7394f1c7906e059393756032c301147a2c4ebcb,19,1684108143,1684272908,ml_lstm,164765
01H65Y8T7ZC5H7GYJG0RV0RBA2,did:meca:0xca33b22b12ec0593cc993a602faae05e18bd39e1,57,1684132905,1684428559,game_3d_rendering,295654
01H65Y8SSMA2CE6JNRW7E24AFK,did:meca:0x8409efcde26ae14942204230bf2c590731be17cf,48,1684136539,1684276086,vr_env_rendering,139547
01H65Y8SNXW4GSSTRJJ4RTRDC0,did:meca:0x5dfeed1d421d2f076aac16c9a893fd60fbfaf5cb,82,1684145811,1684245955,game_3d_rendering,100144
01H65Y8SKQSD431DQ7T0XCQP0X,did:meca:0x5d8f33b782cd82b74397e69de2f288535d35e20e,14,1684149467,1684419604,ml_lstm,270137
01H65Y8SMVB3FWXWCBJ1RZ4XSA,did:meca:0x3ce1b0867c89944b1f25e397db2c32116245a176,15,1684151976,1684179946,ml_lstm,27970
01H65Y8SSNY8B9XGWCVEF435B9,did:meca:0x477cccb0680ac620d0540485dc7441470ae7e16d,97,1684157631,1684346782,vr_env_rendering,189151
01H65Y8SNF6F3736T67FR4VMME,did:meca:0xe4ce0956e5ae412c79f82c3d40d316f8c2cabf5a,1,1684176719,1684243772,ml_lstm,67053
01H65Y8T1XZ0NE239X2WF0M5AQ,did:meca:0x572b8e5bf116e60041fb6b78e414a7d9eedc83dd,39,1684183582,1684195417,game_3d_rendering,11835
01H65Y8SNJ77KBPH78WXH6HF78,did:meca:0x34fefa39c994da2342f949cbc00d60e7e091e6c4,34,1684196396,1684243090,ml_lstm,46694
01H65Y8T1HA00A0HV802RMTHTZ,did:meca:0x579c2a8fdec8e3d9179cb504e8843ecdbeb3acc2,68,1684201874,1684306987,game_3d_rendering,105113
01H65Y8T079DNHKK1KFW29EB1F,did:meca:0xb90b0a60427a68341b5e02c4ebcc96925edd8ffa,66,1684210313,1684222246,ml_lstm,11933
01H65Y8T71ZM8H12NTS6HGGPPQ,did:meca:0x9143f488fe11d16f63a0e2952c60e6b3f4906bd3,82,1684210512,1684346577,ml_lstm,136065
01H65Y8T3KHWMWNAFB4KY0YQ0S,did:meca:0xe87906ff442cf57b019d9e39837efef1789e4f0a,16,1684220270,1684503664,game_3d_rendering,283394
01H65Y8T2YT4HWW6MMPN7YE149,did:meca:0xfd20fdb7c77d072ce62753462a9c0dd1fdfa6406,92,1684235093,1684277553,ml_lstm,42460
01H65Y8T5GXFFDT92ARJSKANKY,did:meca:0xa7449e2056b7c671807b723367ea970af8d1be14,24,1684236736,1684332884,ml_lstm,96148
01H65Y8STN1Y9SEP9RMS752BJ4,did:meca:0xe5edb13a04300097e1f3287875a95e01c71fb1ee,9,1684301614,1684546739,game_3d_rendering,245125
01H65Y8SRAMDK5QDFS2MWB6PK8,did:meca:0xb613f2fd652f76735b62332ae372fd72f2e4a752,35,1684303929,1684514038,ml_lstm,210109
01H65Y8T2W0FWTHA77K86SC0VF,did:meca:0x753d305a6b52530b5e7e25d39853e01608af1586,31,1684316385,1684453820,game_3d_rendering,137435
01H65Y8SSKC4BPQ0T8NYBK6DY2,did:meca:0x47eb6380c7fa3cf64926fb5ad0e39f19a6b21f12,29,1684325661,1684377894,ml_lstm,52233
01H65Y8SVZWE81NASK8V98FNBJ,did:meca:0x52894d3cf02d85f5ae0b73dbc91cc9cfa10f6cbb,11,1684339383,1684370029,ml_lstm,30646
01H65Y8SQWZ6A1ASQKA43AKATZ,did:meca:0xb3a3ab2492319934ff410e34b8437090e9e889f5,64,1684346348,1684346793,game_3d_rendering,445
01H65Y8T3AJ7A7Q4CYE668J3YB,did:meca:0xc5481e968f5bfafb1b01b762f86d7ac99600d623,74,1684358645,1684593765,game_3d_rendering,235120
01H65Y8SX2MNBGREJBCK0GKCG6,did:meca:0xd17108b3cd894e8d54f49e52cf774ecaea4f9935,15,1684380938,1684469471,vr_env_rendering,88533
01H65Y8SPAVQ3456RC7TPFEEAY,did:meca:0xd2dd707c76e77a276273c46d79a1926477cec745,23,1684386283,1684392210,game_3d_rendering,5927
01H65Y8SJHM5CK2KBGCGJGXRTP,did:meca:0x4b1e07d00e4b97a4ae8fbbc3895e093b9f44b249,19,1684395067,1684709444,game_3d_rendering,314377
01H65Y8SVWWWZ84BMHXR7BRP6P,did:meca:0x55161dffcdfbd2e56025527f57135c55b3103d22,77,1684430852,1684545402,ml_lstm,114550
01H65Y8SS1DEM7F93VF5FTS74T,did:meca:0xf21e038ff050e963864fb9f489badb1e12f7abfe,55,1684507253,1684559987,ml_lstm,52734
01H65Y8SW7NYR1RSZ7987T0EH5,did:meca:0xd375ab2382796dd7a3c35069ec74bbae446a70a0,72,1684517737,1684756294,game_3d_rendering,238557
01H65Y8SJ425NTK2H1G8XZNRBJ,did:meca:0xbc09636bc8eb9eae0fac4815789b4fd99ffe39ec,3,1684528598,1684554858,ml_lstm,26260
01H65Y8SZ6G8XC8XPKRVP8QPFB,did:meca:0x875d01c0ba138c1ad5e084c25116743f84f18389,53,1684577263,1684705037,vr_env_rendering,127774
01H65Y8SYHWV6KQ1YM9D47FD94,did:meca:0x42dd49211a76bec22672938cfe068822874bef70,38,1684577761,1684589859,ml_lstm,12098
01H65Y8T196Z0Q5MBMZ1CWE09N,did:meca:0x9165ad5c0326d5227b3871fedd17a126afb52a16,7,1684597853,1684620568,vr_env_rendering,22715
01H65Y8T7RWNCXFZ5T1K352FQR,did:meca:0x49081541546b93dc9f2cd1f62ea2f55cbc5b8234,85,1684599822,1684615488,game_3d_rendering,15666
01H65Y8SW86PK4QM18ATP9R8V6,did:meca:0x99d7a7b50de414fde89974692dab335b34641173,6,1684612828,1684772946,ml_lstm,160118
01H65Y8SQVK59JG4BY7VDF8AJ1,did:meca:0x1cd63e51431edf15c8b8990c0c80c917ca049bbd,43,1684619178,1684763542,ml_lstm,144364
01H65Y8SYX7WA88ACK5QE9ATVX,did:meca:0x75f925289aa9a7b6b4ce524e5947cc8ef9c99931,69,1684689996,1684773483,ml_lstm,83487
01H65Y8SNVTM0ED14KQRN6E05T,did:meca:0x5a47b0824aa3bcc266c7e362115668f3b5fbc454,1,1684736995,1684778303,vr_env_rendering,41308
01H65Y8SM9YJZ16TA77FTTG6PA,did:meca:0x423719459c4575553b3a8bea32d22553e0c8488f,2,1684749540,1684809641,ml_lstm,60101
01H65Y8T0BHB13AM38RVKMBRAC,did:meca:0x3b7b258ce172ec91ac7d07f6430cafe621a3c084,35,1684751476,1684879302,vr_env_rendering,127826
01H65Y8T45D5W8AS1MNH42CGWW,did:meca:0x4a7ff5e5c884f07c8834490c80d1e44e40498f35,68,1684761669,1684857036,ml_lstm,95367
01H65Y8SNRQWVD4RFKY4D45728,did:meca:0xa23bd65728115307669723825abead773627a3d4,31,1684797393,1684800628,ml_lstm,3235
01H65Y8T832AMQAX1SC6CYZZJ2,did:meca:0x782f664d99f6cdb5b01464329ae09311b5c52712,98,1684831468,1684850689,ml_lstm,19221
01H65Y8SZVDF6FSNCP54Y49VXJ,did:meca:0x8c713f75ba8407f98f1c7d3a09d19742b43cb129,69,1684838069,1684962443,game_3d_rendering,124374
01H65Y8SVY4XHPP1M3GGKWQWNB,did:meca:0x34937a09c288f9de651af0ddf5ae23bca966339c,64,1684860779,1685090100,game_3d_rendering,229321
01H65Y8T59AQ95SYM4W7BR3WSB,did:meca:0x9fc945029e616c5691a0dfceced8b8095e09ff1a,51,1684872895,1684916375,ml_dbn,43480
01H65Y8SRW9M6T3HRSS6HEAXHG,did:meca:0x63ddffacdef9cef3358890823d0a82bc641c87a7,72,1684890767,1685010621,game_3d_rendering,119854
01H65Y8SM0MY6F42F7SX990KT2,did:meca:0x011d37e07b72e7e6288b326a23a5bcbab5add472,93,1684901833,1684943388,game_3d_rendering,41555
01H65Y8SXM3S90AFQVE79TK914,did:meca:0xffc5ed7500386ce2a0668288b32e7403af6165bb,96,1684905079,1685019229,game_3d_rendering,114150
01H65Y8SJR1JZJRQ3RZBQ2MXMM,did:meca:0xf11e520c953b9f0332af1bea7567a70a93f0ae6b,69,1684910382,1684910445,ml_dbn,63
01H65Y8STVE2KJD4J4S7AJ497N,did:meca:0xeaba30a9dd1edbdd8e612fd16f92a34dd9b52333,49,1684912191,1684990496,game_3d_rendering,78305
01H65Y8T7QVDDYQN9J4RWQM2B9,did:meca:0xd9e79945735a33b8c915999683ad477a2556a46a,48,1684917484,1685018063,ml_lstm,100579
01H65Y8SKTSPVSNNMR35TJJDXK,did:meca:0x967b7f3b5fd7a5b111d07d526dc22d7dca6e5740,98,1684920636,1685007962,game_3d_rendering,87326
01H65Y8SY6QSW6CD5J906G3YVY,did:meca:0xb529ca6c5a2bbbf5c44ee7886a44e594e61b7926,53,1684977679,1684987493,ml_lstm,9814
01H65Y8T6PB8Y1HA8CGSJ7HA0E,did:meca:0xa028cfc18c0a62e6700d8dc7f8718c3eb38a699a,92,1685000289,1685316966,ml_lstm,316677
01H65Y8SSQ23R5EXC9QTEE8DKM,did:meca:0xb94ecadc5addcaf940210f3029f5ed81f267f1c6,52,1685018315,1685047609,ml_lstm,29294
01H65Y8SX4JR98A0096NFRPQDW,did:meca:0xfb1fa87205a5124ae7f7d90a4cbcbfa55c6ab9ce,57,1685045361,1685136197,ml_lstm,90836
01H65Y8SNZ424NMCAYRJNWJX36,did:meca:0x1bd7f430f74f7afeb34a5c178ced24fee8e74875,64,1685068815,1685136932,ml_lstm,68117
01H65Y8SWPDZEGWC00P2CD9JNP,did:meca:0xad88a4702332c3de0b21a05f6f5dbbe4b0900a37,66,1685078334,1685140501,game_3d_rendering,62167
01H65Y8SN3PWCNKFX818PX5T6D,did:meca:0x2e335500be632ba88f07359e3539e7406956c6f9,77,1685090193,1685156716,game_3d_rendering,66523
01H65Y8T7661NGEYZ9X8GDRBQZ,did:meca:0x17d1e267add57efdab3bd60b6a43613b6a2133fb,64,1685147860,1685308081,game_3d_rendering,160221
01H65Y8SP10BWE6AWG536RX6VP,did:meca:0xb7dceb54a64c44f588c9626ef6be8a5a5c943e44,69,1685148246,1685178750,ml_lstm,30504
01H65Y8SRD9JR0QDPS0D5174M3,did:meca:0x27799ee5fed1b2f3cb661a7783e5871a24475788,43,1685158852,1685511598,ml_lstm,352746
01H65Y8T0DEAJR1FEGFVP5NEJZ,did:meca:0xf4174e289116cac63397eb18c3ac2ed2ab5d5575,65,1685191950,1685447148,game_3d_rendering,255198
01H65Y8SPZF7ECG9BGCVBQS8TK,did:meca:0x597a113a998888172a16274d2ef048a5c06f5814,31,1685195538,1685252054,game_3d_rendering,56516
01H65Y8T7RW44124V309VXTCNH,did:meca:0x676a996986c7bab85e88caefdd170708b155d38c,57,1685197315,1685368820,vr_env_rendering,171505
01H65Y8SSFD6RZDXGCPMKT29X0,did:meca:0xb79cd034d2095da5a1b4444456b47ea8f3a1d8af,17,1685209352,1685439925,game_3d_rendering,230573
01H65Y8T22S5E910SJSNZMWJ95,did:meca:0x4648c659f9f2e379e8846a91615035708078742f,28,1685232732,1685330627,vr_env_rendering,97895
01H65Y8SK78DTVE0358XFQ1WRQ,did:meca:0x57b9c1d0bbd4b19f57df0fb2a0ec70f110975834,39,1685249480,1685525904,game_3d_rendering,276424
01H65Y8SRQG2FGWAR7H2NHV0B6,did:meca:0x0d3a6197fac8f09869273a5354e5171c51cf4143,66,1685284415,1685359844,game_3d_rendering,75429
01H65Y8T4V6TC3N4RYC0TFKRCC,did:meca:0x3d792e8bbd15789e165a4f4bd5230e046e0b7a61,21,1685284979,1685389347,ml_lstm,104368
01H65Y8T2XSBA5CB9YSKAB2XX4,did:meca:0x207191152eacc9f2cbb248700c2604cc8cfb1de7,74,1685291950,1685396247,ml_lstm,104297
01H65Y8SWDDNKP8346BRZDCRF6,did:meca:0xa6ccabb1ba38683317bb7ece407353542376d501,32,1685310206,1685411147,vr_env_rendering,100941
01H65Y8SJE43W5ZWGWCNRDSG3Q,did:meca:0x6a35f8ec1c3c5b0303617df5a74758b0405a84a6,42,1685372520,1685373557,ml_lstm,1037
01H65Y8SQ76E46AZ1JZQYK3WTS,did:meca:0x2d7bde51e10fdf60e16facf56b081b86742e2db1,70,1685374289,1685587006,game_3d_rendering,212717
01H65Y8T64NQDTRNVJ18J3F6DH,did:meca:0xf6371f6bbc8dcf697d80e12d346ca349b11e7070,16,1685390629,1685723735,game_3d_rendering,333106
01H65Y8SWRF5A2K6ZT5BN8760A,did:meca:0x9267833b186660d49427ac303b629928f46d6dd9,30,1685406361,1685669907,ml_lstm,263546
01H65Y8T7DD68EKAB5M35TPGMS,did:meca:0x0b2d988ffe7e4b4b3e94a332badfc07c0f2113ae,88,1685413418,1685498368,ml_lstm,84950
01H65Y8SVMAASTQ1HGPHGJB716,did:meca:0x3c817c01a5e6b7edae8603dcbe6cdd977f39624c,80,1685441526,1685489874,ml_lstm,48348
01H65Y8T76N7NRSP3X451WPYJN,did:meca:0xb4a96702f1d0d1d1c9332e6c115d89fd5b85ecc9,23,1685457025,1685582653,game_3d_rendering,125628
01H65Y8T18KCP3JTCAPB4E0RZS,did:meca:0x13799e8845ca217f63228e86f14b347255486c20,83,1685468530,1685720950,ml_lstm,252420
01H65Y8T7G19Z6R1V3C0F6REY2,did:meca:0x1535505d00797ced402411e86d9909fedab9f2d6,46,1685484919,1685626163,ml_lstm,141244
01H65Y8T1K3XFR826P0ZXDJCKY,did:meca:0x2117d514c94d5aa082cf7f77478cf441b8d5940d,15,1685486866,1685554298,ml_lstm,67432
01H65Y8STYNNS540Z1CNTPPQZZ,did:meca:0x35f92a6c5236931d129486531b9a0839fabfc0c2,77,1685492940,1685567388,ml_lstm,74448
01H65Y8SR5JQTG2DA0JBPPNCPB,did:meca:0x9ec363756c6c5ad015ef60924739d910a9b23a56,16,1685496562,1685753181,game_3d_rendering,256619
01H65Y8SVHE6CQVMXW1P4E3Y4H,did:meca:0xef17ebb5811619ddeb545287703777c805f1a914,25,1685523779,1685547269,game_3d_rendering,23490
01H65Y8SJWGD32FRZTA5901MW6,did:meca:0xb0a438f91c083f4b198982e384a270d0850748ca,71,1685531056,1685584983,ml_lstm,53927
01H65Y8T0ZCPK6GKJKHREF4653,did:meca:0x1d4cd7fc93cc14713003e892e9cb31e68748cec4,16,1685555230,1685625277,ml_lstm,70047
01H65Y8T37AXEBVZRRG6WVK67Q,did:meca:0x0fa57891e2d5a003b5b213da1666812d9eebe69b,85,1685566886,1685589578,ml_lstm,22692
01H65Y8SRC5WHRJGT1N5493KZK,did:meca:0x5401466f940123ac3f0152e89cc40509e5628f78,5,1685572553,1685733280,ml_lstm,160727
01H65Y8T7NJG4908MDKXA731B0,did:meca:0x78b9981fd6235068fe2608349d1c3fff18300f2c,3,1685581136,1685733551,ml_lstm,152415
01H65Y8T2AFVE0F1MNR0GND70R,did:meca:0x3498d6f83daca3b5031955341799fa3293df468a,44,1685596465,1685701738,game_3d_rendering,105273
01H65Y8T2390KS3R491C4V6418,did:meca:0xc7259d9c014231246af390a598d3af56df01544b,38,1685626999,1685674679,game_3d_rendering,47680
01H65Y8SS83819H74R687G4311,did:meca:0xa12c3099a0c3d57eb0d9e1e37e733d5a8aa57edc,68,1685647013,1686017730,ml_lstm,370717
01H65Y8T6CZ63K29Z93GKZ5R98,did:meca:0x83a8f1a83c38c7b9ebf7eae5e091dccd8e2a89b5,23,1685654315,1685915420,ml_lstm,261105
01H65Y8SMTDTB866CHWGAPVTT3,did:meca:0xec9aba3ac80aa5486ba45522819a96ed8a5d66bf,11,1685662999,1685812382,game_3d_rendering,149383
01H65Y8SVJJVDMM3K3H2HR4VDE,did:meca:0x9e796a91faefc41be18e97446257e20d8f22211c,10,1685682050,1685752176,game_3d_rendering,70126
01H65Y8T5JG01PTAK25HXXFMNN,did:meca:0xc68ce5c13a687bfa285942d30cf36a2e284b8238,63,1685682069,1685791178,game_3d_rendering,109109
01H65Y8SK64450XYJV1ZPH71RP,did:meca:0x1549c9c74f164697f611ce6947d625afc8264eda,19,1685682472,1685698332,game_3d_rendering,15860
01H65Y8SKXG7FZRAHPZPC5JHGA,did:meca:0x209f7d74f2016e70f555fa48849cac2647d8d15e,3,1685687737,1685764228,game_3d_rendering,76491
01H65Y8SZCW5QRM06MFYXMJ42Y,did:meca:0xec4f39f097c18ed905ef699c78ba29e294f5adc0,72,1685697941,1685720586,ml_lstm,22645
01H65Y8STKMKEFB65XD9R4P4YM,did:meca:0xdd091d5bef7b3b9b457150a993f0054aabdbbb7d,1,1685729231,1685772308,game_3d_rendering,43077
01H65Y8SJ7HP8Z03Q59KC1FGB3,did:meca:0xd888eb076ff005ce7b23083427f86a127748b69f,96,1685750598,1685939730,game_3d_rendering,189132
01H65Y8SQBN5PAZCXNGV7RHCB0,did:meca:0x0766ccd302fcf7e896d9b83bee91bb71e5d41d20,54,1685779482,1685953621,vr_env_rendering,174139
01H65Y8SM1F0MEQA6SW31WSKJV,did:meca:0x486889dcd42316aa47be9e104a9bfc2d11b8d9f7,29,1685782147,1685908211,game_3d_rendering,126064
01H65Y8SX472HQW6SBY8VPD1HX,did:meca:0x76c92fee6babe0913cd5a4e746f993dcabab9035,14,1685786257,1685835652,game_3d_rendering,49395
01H65Y8T5MMEASA4CJ884ZFFJA,did:meca:0xc2077e5f5173983316077e58217a2d29ad7b8638,58,1685788305,1686070225,ml_lstm,281920
01H65Y8SKDCSG5EYYW1C38FYZP,did:meca:0x70f817877feed673a082a742fd1e084f832d51b7,79,1685807916,1686070247,ml_lstm,262331
01H65Y8SPNFEVYKV5Y8BWNC06T,did:meca:0xdc0ef1f382bb44cfc904e372b9840afce771f105,53,1685809138,1686068158,ml_lstm,259020
01H65Y8T04BTT976PCQTQRMARA,did:meca:0x1b008ef223d021be483dd07334777909b287c0bb,67,1685820252,1685938301,game_3d_rendering,118049
01H65Y8SWHFHV7HFQ3CXAPWEXZ,did:meca:0x5640acd1d049ffa6cfc9a0ab34dc322e23462a4c,14,1685822763,1685852447,vr_env_rendering,29684
01H65Y8T6JFZZDREXBR32028HQ,did:meca:0xbaea9a0015faf96062dc38c3a08601ea77015cdf,92,1685829829,1685922860,game_3d_rendering,93031
01H65Y8SX9E982DSVNBE3NGWH0,did:meca:0x9833b55e4085f64f7784a38296f11342662bea78,15,1685847355,1686112715,game_3d_rendering,265360
01H65Y8T77AG42DC3VS306ZY0B,did:meca:0xf81de592bad76c62534a98aaf282d6bcb20e72e7,14,1685869201,1686180610,ml_lstm,311409
01H65Y8T6B6VP520X44PQ2HXYP,did:meca:0x3d01365b793983cf3b5cc0b81d2c8acfdb455c9e,87,1685927524,1686131900,ml_lstm,204376
01H65Y8SPWSVFGK9YXM49C6TPG,did:meca:0x009c9ca0ac698a2988a14b5ca0ff11eca46d2099,82,1685931694,1685988417,game_3d_rendering,56723
01H65Y8SX3MP9M5AHSHAYWYFT8,did:meca:0xe2e9866d805336a2d6f5cfd0989de45aec987ebb,46,1685986792,1686088883,ml_lstm,102091
01H65Y8T2K5WJ891VCZRB3HDKF,did:meca:0xc8b6d2ee14f70e33e818913864c0e26b321e193f,17,1685993288,1686082943,game_3d_rendering,89655
01H65Y8T7V4ZGWATKD2M9FFGSF,did:meca:0xf188dab6004b13a9ba7f5d63df43f7ce2d34d1ed,76,1685997313,1686183567,game_3d_rendering,186254
01H65Y8T4WH07MJVRP80H77WK2,did:meca:0xd714c7bcfd1bdb41988e44d1e6f81c8098a15a90,76,1686003391,1686042894,vr_env_rendering,39503
01H65Y8SPGMF6Y6TD5EW7XWBKW,did:meca:0x0542b28215cb9bf887abf0dae4355580bb69e4e7,23,1686016432,1686180186,game_3d_rendering,163754
01H65Y8SWEB17CTESXKNJJBHMG,did:meca:0x7da96886f175a14f2478bf59eccd4bb657d96352,14,1686017375,1686072529,game_3d_rendering,55154
01H65Y8STS35J8FGPT0YJVY9NW,did:meca:0xa5cedabe091aba5ca9e8c3818a15197dc9e260de,40,1686025872,1686204850,vr_env_rendering,178978
01H65Y8SPP6XCAGQJ3W1C2Q0N8,did:meca:0x6733f2490718b13b809668e36d425be41fee8c37,10,1686048834,1686119402,game_3d_rendering,70568
01H65Y8SSHPV4T8VBVRS0Q4W5P,did:meca:0x8cff703b5fc248f562b9769cee185cce2b0ecccb,82,1686083946,1686189740,ml_lstm,105794
01H65Y8SXY0NNRRXVH21PXER1H,did:meca:0x3ab622cae0d8d74090c512dc394e574345d2f61f,85,1686133071,1686257514,game_3d_rendering,124443
01H65Y8T5R9TT9W5FF25VXVN1Z,did:meca:0x1513d9b660631901c5b6003e564a15546481ffcc,78,1686143552,1686188318,game_3d_rendering,44766
01H65Y8T66PG5HNB685V1AWRX0,did:meca:0xe49f414976f71aad9d84adfbe43a09cb6764b3bd,79,1686150544,1686154269,ml_lstm,3725
01H65Y8T4TEMXFNQY8E8HB8S7N,did:meca:0x5e36613a082eb11d18a0a0f2faffa50a34b6af51,18,1686228259,1686348639,game_3d_rendering,120380
01H65Y8SZX29HTF8T5VFVASJQP,did:meca:0x38e31743e6304faf4ce6ec53a96fb379900f02dd,73,1686279001,1686444896,ml_lstm,165895
01H65Y8T3KT4QRCM53PJS0MN3Z,did:meca:0x54430ad27912c3b42ea2ca4d80b179e447582f2b,78,1686282263,1686379570,ml_lstm,97307
01H65Y8T42470M78Q5KM0PBNDY,did:meca:0x8f43d3d8d39853a538ecb2130842a646dc00dc7f,40,1686287696,1686345785,game_3d_rendering,58089
01H65Y8SVPZS2CKRS73JE0EGTE,did:meca:0x4076b1a5639cbe4df2ad6e8cebc1cecd8eb509e4,2,1686308994,1686449934,game_3d_rendering,140940
01H65Y8SYAZPEB7M9ZR8JN66DD,did:meca:0x83f7c5a3769abf585d5298acbe536a27a6ff79f9,91,1686317235,1686326855,ml_lstm,9620
01H65Y8T5Q7R512CAN1YQ9Q0JY,did:meca:0x89abec7afbcf6777ceffadfa528df2761a0935d5,80,1686320143,1686415485,game_3d_rendering,95342
01H65Y8SK03HEV5J2DPKGS7SQF,did:meca:0xf2ac31f75be9f7f04eb6bb7736087b3b4822144c,59,1686382537,1686664179,vr_env_rendering,281642
01H65Y8SPXW49Y5F9XP8F429ZJ,did:meca:0xb3e0ecfa7a1d6671ca611d3c1465ba1c4495cd29,73,1686385022,1686666662,game_3d_rendering,281640
01H65Y8SQGYVVPCJ3J2Q2Q5BPG,did:meca:0x9a02624950d791d1fe26d88711c0b8e0af2bb73a,81,1686388609,1686430027,game_3d_rendering,41418
01H65Y8SY9J9XW4TRSBMXYCPG6,did:meca:0xf0274ce2517525190e6b28fb42e6f4ee338de40b,98,1686417002,1686670779,vr_env_rendering,253777
01H65Y8SQP2DSRRBKG6585850D,did:meca:0x2a30b131929e4f1a930a6f3ccc43e592aa305c31,45,1686438707,1686543127,ml_lstm,104420
01H65Y8SWATX3017AM00VD1ADN,did:meca:0x4dcfe9a32580012301dccffb9bde6e1d9e23d584,80,1686445825,1686542102,ml_lstm,96277
01H65Y8T362ZYH6KDQC3YDWEYX,did:meca:0xc45581abfbe1e048a2a882b18cafe241eea2f59f,23,1686462515,1686607591,ml_lstm,145076
01H65Y8SQAQDMJWD2YRX4HWSDA,did:meca:0xfe231086466e0a5904385972b6f2245b6fc99b02,32,1686465080,1686537550,game_3d_rendering,72470
01H65Y8SQMK29XW71MP55GGAQV,did:meca:0x17fd016f8537b7fb6f4e4df7768514d1e5f38c56,28,1686473135,1686787004,vr_env_rendering,313869
01H65Y8SP2H1ZAPMS0YXB1MRGJ,did:meca:0xdc8f9282ae17f31ddfc2cc724514d9885938d30b,36,1686492496,1686494825,game_3d_rendering,2329
01H65Y8SPH9RVAXZ8PZ6G76S4D,did:meca:0x2100ac219df09bd223dd73d8ec964aa7a784e18b,18,1686509702,1686670448,ml_lstm,160746
01H65Y8SK5VP9D0ERP5GQ2PTGB,did:meca:0x970e92b2894195975701cd6273f8a048a12f730b,41,1686509837,1686769935,ml_lstm,260098
01H65Y8SQ8HNYTNY02GZGYRY7F,did:meca:0x6df74b0f5a358b59a1139fe925cad9bf3be3b985,94,1686513996,1686597196,game_3d_rendering,83200
01H65Y8SJAQ4YZN7QPN16XSBY5,did:meca:0xde489a37695504467907c601f245806bf52d5c26,43,1686519601,1686527447,ml_lstm,7846
01H65Y8SPJSGR4JHVB9740SBC3,did:meca:0x34ae6e6ca55c6f11044d0abef4ca80b744a49391,100,1686524029,1686793897,ml_lstm,269868
01H65Y8SJV3AFH91068QEF88X7,did:meca:0xa88f58692f4345c88d8df49d978c20af7c0e258b,2,1686531268,1686631075,game_3d_rendering,99807
01H65Y8T2KPVRSSBV69KQ4TV8F,did:meca:0x1c7db05a7e50a0ad0b08c1cf039e563baa6ae872,26,1686547071,1686633882,ml_lstm,86811
01H65Y8T3SJ4W2JHYXA9XMZ4TA,did:meca:0xeba831bd7afc83aee0aa2bc62aee697d04955896,49,1686548814,1686621623,ml_lstm,72809
01H65Y8SQCQXJKWQECDJ1R29HC,did:meca:0x41b800045495c68edde00cb35d9cfeb0fe00d1fe,14,1686553626,1686798064,game_3d_rendering,244438
01H65Y8T4Y08S30Y4NEEH4BR6T,did:meca:0x6600020039f095efec586d86453aef3edfd26bc3,14,1686567477,1686574883,ml_lstm,7406
01H65Y8SSWQNNG3NDHMR59F73X,did:meca:0xb924568bcfd0252d2ec242a35ebfa914945ba7e7,67,1686573648,1686698594,ml_lstm,124946
01H65Y8T256NQFW8WAQRXPV0HW,did:meca:0xb484da8ee2ea7f0b18e81aa4e41cc8da0bb37fde,29,1686574367,1686612220,ml_lstm,37853
01H65Y8SVDY7B3G0W4QZG868H1,did:meca:0xffe50eb7ed1a53c4eac8515ddbe367df8f9dab85,30,1686583213,1686704692,game_3d_rendering,121479
01H65Y8SMYNW0B2PQ3FYBH2JBW,did:meca:0x33a6ea85f688a49888a6581829869de4c921f7f2,92,1686589028,1686655679,game_3d_rendering,66651
01H65Y8T1WCRNZWZXRYYX6HFB8,did:meca:0x6691f0e1c0f00ae7f7d894adb73bdd8e5a217d19,37,1686648673,1686709122,ml_lstm,60449
01H65Y8SW6MWZKD196E2KX5ZZF,did:meca:0x0742dd54c142ab5206303bd854976c406e9634ef,13,1686666762,1686706620,ml_lstm,39858
01H65Y8STT4FW0S1S2V79TT15D,did:meca:0x13a2a32d5b4c68bb024bb1034639bf69e0b6f092,80,1686672351,1686814654,game_3d_rendering,142303
01H65Y8T1PZM0XXVQM0X0BSPG5,did:meca:0x3e6221a6a2452ce66180fb958ebcc01690905b39,21,1686684803,1686925513,vr_env_rendering,240710
01H65Y8SZ4C0W150QGFBDR2Q6Q,did:meca:0xf31f5b39f6ae611db98640d21030650357cc9bf2,85,1686686554,1686826198,ml_lstm,139644
01H65Y8T5NSMSYB3DH80B0HB5R,did:meca:0x4aabc89c50ef52409c57ba8e562721ee6d3ebaff,81,1686746464,1686800595,game_3d_rendering,54131
01H65Y8T53G7Y534XFA8S4GXVC,did:meca:0x5aea3b105cd21f95e9df75defcce208a2fc3dd29,98,1686750843,1686831081,ml_lstm,80238
01H65Y8T41NDS19QFHFPXAZ6W8,did:meca:0x830de154d6372bbfd00c4e8021f7c055e90f9525,91,1686756847,1686971912,game_3d_rendering,215065
01H65Y8T5BPEZSJKZPFNTRXC4H,did:meca:0xd120d6afd89b6696dc44d5bfab1a9c15d637cc83,20,1686763427,1686855192,ml_lstm,91765
01H65Y8SSD51SARDAQ9AV0GV6E,did:meca:0xa786b9ec50378d4132c3e4adbb625e9ae4287f51,100,1686763461,1686948062,ml_lstm,184601
01H65Y8SKPDJCT44E946758HJV,did:meca:0xbba85d416b33f042876b25fcf8ce2cb45f100970,99,1686771045,1686812587,vr_env_rendering,41542
01H65Y8SR85V076T79XJ5KA8SH,did:meca:0x39e0d80de8ad983a575c6df6b869eb8a814ec705,65,1686790864,1687053251,game_3d_rendering,262387
01H65Y8SYAX9BKQ7AT8T3YMYAA,did:meca:0xf8132da5bd995fa80a37236e00c6f7df982d4e13,7,1686821340,1686979805,game_3d_rendering,158465
01H65Y8T24BHMHE9DRFZS6MV61,did:meca:0xc4d531dbe435171d164eaa41fc1864db26e876ca,32,1686849400,1686963469,ml_lstm,114069
01H65Y8T1NWPZN2XDD8V2YC589,did:meca:0x03234b238620849fe6f2f8d394ce86f0667441b8,60,1686879139,1686992775,game_3d_rendering,113636
01H65Y8T6Q71RWSNG9T20YW4C5,did:meca:0x31e97a0e3d265fe8b208a0f04ebad3424443fb0e,1,1686883602,1686983173,ml_lstm,99571
01H65Y8SZ4RGN3K79M6RM5QEY1,did:meca:0x2e3c705562015f760e3d2f2a9a3942326030d485,73,1686893735,1686961607,game_3d_rendering,67872
01H65Y8SV4EJV0CX5P55M4PC52,did:meca:0xc069003b1a51d7f0dc3daafbb1817e27055fe4c2,85,1686906543,1687116953,ml_lstm,210410
01H65Y8T7NYH5TN548EG367CP0,did:meca:0x05fc3aa1d18a791370824bc98f595e6a5cc7b8a1,84,1686946632,1687192500,vr_env_rendering,245868
01H65Y8T81T83ENK8E5KQQ51VA,did:meca:0xd3d92d0097fe265664cc9b1340e192e9c01e07a5,24,1686951917,1687119336,ml_lstm,167419
01H65Y8SP2B0A3G7HS3Z8DA0PW,did:meca:0x92327dd76c97490112d4a8b784c7761d1955683d,9,1686970699,1687066337,game_3d_rendering,95638
01H65Y8T4009YE4274XBYF5ZSW,did:meca:0x7f0dc43928e2fa5942b15fdd1b9458c268b0c40c,59,1686979415,1687058084,ml_lstm,78669
01H65Y8SS4E8VKPY34K2J1C2BK,did:meca:0x357af2a3355e2a5e92654c40f43454c52fda6f45,52,1686984645,1686989505,ml_lstm,4860
01H65Y8T1HDV44WBXQS2DN17Z7,did:meca:0x6641b723053ffba6955d879c686ee600cea88de6,3,1686985621,1687163724,ml_lstm,178103
01H65Y8T4QT70C0N5K278GZX40,did:meca:0xabf9ad4574589b1ae421355efc0034a8694d765f,88,1687018050,1687208870,game_3d_rendering,190820
01H65Y8STP7QGP7W0A40J1Y3R6,did:meca:0x94059aaec9023b43d875f2d8ddb17cc1654905bc,47,1687063313,1687275694,ml_lstm,212381
01H65Y8SMD2122PHGJREYENR90,did:meca:0x6dbb8e25d482c40afd04c105b8d554fd3d7e6f7d,14,1687073839,1687099528,vr_env_rendering,25689
01H65Y8SVBAT9Y8FDHGX7ZAV4Z,did:meca:0x74116a78a99d7c9b8e4627f66f699a85b44982a0,74,1687126741,1687216494,ml_lstm,89753
01H65Y8SXH32NSXPCK4PWGZDK5,did:meca:0x67cb95397e1f28ba7463319eaa41905bda289228,10,1687137506,1687253124,game_3d_rendering,115618
01H65Y8SMATT1YH4XEFSN0G5MH,did:meca:0x9cf0785b46f31fd49bd31914e71073b69bd6b35a,84,1687154393,1687373657,game_3d_rendering,219264
01H65Y8T5DZJ6C8BRYS28WE10P,did:meca:0xc7dc6df6b33473f03bf32da46e3f5406c3191241,6,1687159604,1687330060,ml_lstm,170456
01H65Y8SMMTAMWBWD08VTXYFQR,did:meca:0x2cfefa1bec12c09a91c2d4ebfc56857a5274bb9f,42,1687180109,1687333400,game_3d_rendering,153291
01H65Y8T64RFWF0K76NJAC3R2Z,did:meca:0xc6bc76d279941b13934998489aab02da322ea970,67,1687180335,1687186407,game_3d_rendering,6072
01H65Y8SJBH9NDKSJBBQQFHQ86,did:meca:0xc3cc7323369de98917f164c63eebc2beeee308fe,55,1687207833,1687649393,ml_lstm,441560
01H65Y8SYS9JYBPZ2QXRP45C7X,did:meca:0x2ed3c7cade1991fc839fa8a5812fefd98e2ab519,28,1687213040,1687310666,ml_lstm,97626
01H65Y8SJGPQ3D69CG3DGDXKG5,did:meca:0x29ee2bd07edb1348a13b051e687693992728d8be,26,1687221782,1687465908,ml_lstm,244126
01H65Y8SSPEN94Z114PSB67C3M,did:meca:0x3e63262e3c67e4c23e5ee7831c5be340a5b2afde,57,1687247431,1687502733,vr_env_rendering,255302
01H65Y8SYRYBVKJ4C1VBDPKYFP,did:meca:0x1f2a35597fb4d87bc74586f9b03d53b19b0c604d,73,1687250578,1687439631,ml_lstm,189053
01H65Y8T2GSBP0FFCHQWE84ZPH,did:meca:0x1cf912ae50a985369fb30159a70c0b32f0c3d613,24,1687261352,1687447567,game_3d_rendering,186215
01H65Y8SN82VW4AAW4QE382688,did:meca:0xd3931f7bf65d76b576ff38d98e9bf2d0ec159a0c,35,1687262047,1687367901,ml_lstm,105854
01H65Y8SQSHKM02XBJCEDPRG4D,did:meca:0xef3346448de33b89845d6057019cf6b859590ad4,13,1687269392,1687559223,game_3d_rendering,289831
01H65Y8T74CA6C70YFXJWQ41PY,did:meca:0x957ccb690f57a5ab75d812746aa7b559b2dd7ad7,61,1687304743,1687328436,ml_lstm,23693
01H65Y8SQNSWHHNBTFSJ2AGXF3,did:meca:0x878d8c5a8d25d7d12e2e8fdbba2f378360f73b7e,23,1687315727,1687402054,game_3d_rendering,86327
01H65Y8T69VMDBEF7D2J0WZCXP,did:meca:0x6c94f2a0345717226e595636da790d9d0d1e6b87,28,1687391173,1687469350,game_3d_rendering,78177
01H65Y8T6BVV4R9F2XJKT9C8E0,did:meca:0x7c3166d5f4ad3266c2dedac8fc4c625bdb38f68f,10,1687396879,1687476204,ml_lstm,79325
01H65Y8SY2Y636RTB7G26BEFV6,did:meca:0xf9ca1e8f7a74e88fc2e8afd39c1c2a9bb0c74e01,5,1687399874,1687502390,vr_env_rendering,102516
01H65Y8SXTS9XAV5QVMMH8MYC2,did:meca:0x6e0309eafd04241ae55481f2819b45c5a40aece6,30,1687479520,1687904961,vr_env_rendering,425441
01H65Y8SR0FTCSRDWQHQ00P0MB,did:meca:0xab0a4143c5d46f700a498c8ba081ef77eb974ca8,94,1687481187,1687672229,game_3d_rendering,191042
01H65Y8T2AEHF8E8XDCDYSMWEN,did:meca:0x1a6c4e8fcbb58d6f9876092745f14be1f346f9ac,50,1687481897,1687497614,ml_lstm,15717
01H65Y8T0QS2M7XDHVAJ9AHERF,did:meca:0x986633a9bd871ededbdbc0aaff77aac5395e18ea,9,1687501286,1687521274,ml_lstm,19988
01H65Y8SWN6V5FWYW86B2QNS5V,did:meca:0x04d50bd749bb3969b3715c1044525cefa5c04c14,38,1687508718,1687778337,vr_env_rendering,269619
01H65Y8T087J315JQNAQNVQ9CC,did:meca:0xfe286ec1abf905a6a9607c9f236024cb41babec3,7,1687525027,1687572326,game_3d_rendering,47299
01H65Y8SRFNCWS5T63J6991YKD,did:meca:0xaa6b2f515d16739dd99c2c77281bd50adb493c10,38,1687525622,1687616782,game_3d_rendering,91160
01H65Y8SZFNGVMFM4TK4GQT7WP,did:meca:0x183c13074aace22e114021fa2073514a83d35cb6,51,1687539142,1687771413,ml_lstm,232271
01H65Y8SK8CZZGY0EB8MHQ8WNF,did:meca:0x1b6bba1505b9305e3272c1c37df6bedacb88f59e,10,1687557580,1687575092,game_3d_rendering,17512
01H65Y8SXKNR33PA7YW9843WRH,did:meca:0x801465bcbc6ff9c840ffc317a2cdaa6370610db3,34,1687562996,1687893696,vr_env_rendering,330700
01H65Y8SSNKCENYX1NXFSRY5DB,did:meca:0xc3d3b2a33a62a56ece2d6010deb65c8b9c600d11,19,1687565708,1687738121,game_3d_rendering,172413
01H65Y8SJCCQ065Q1DX43HQZ5Q,did:meca:0x1d71ef80b90db54f1c7e2510bebbc9fcda7d64bb,81,1687571942,1687648836,game_3d_rendering,76894
01H65Y8SK90VV0R0WK41S17DPN,did:meca:0xf2324d554e79fb274d60a934a34411ce1938e64c,18,1687605651,1687913287,ml_lstm,307636
01H65Y8T004QTGQ6PHB7XXKCQR,did:meca:0xdbeb2bd791458f3f0b11703b844787d7a62e1a9c,43,1687619148,1687658334,game_3d_rendering,39186
01H65Y8SMNCKSTNDHM17TDFWXY,did:meca:0x9c3b1f4e979af6380a98b242cabbf4c7443dcc8b,90,1687637376,1687907019,game_3d_rendering,269643
01H65Y8SP8GSYCPTH9YPEX0GXJ,did:meca:0x802ad10a34204f2ba62a6a2339c51c80a6e831d3,4,1687655494,1687810306,game_3d_rendering,154812
01H65Y8SWB1QSPZD3JM2HDHHPJ,did:meca:0xd7e847c59ad9de0a2082491bf581f7fce6c29c64,62,1687662461,1687728581,game_3d_rendering,66120
01H65Y8T14BKGFDEHQZHRXC9ZM,did:meca:0x7b7ae00e6ff98d0d15520e498b692df35b718893,55,1687663633,1687720231,game_3d_rendering,56598
01H65Y8T5Y59EFQ0D7XBHM5RQ9,did:meca:0xe26cdb08b49c84e68969a4f3e1d552ed183b072d,45,1687673508,1687683962,ml_lstm,10454
01H65Y8T1GCBC75RYF8BJYFWY8,did:meca:0x69f74ee349907fb3a05a50d37a80cb0927b00b30,35,1687711205,1687896784,ml_lstm,185579
01H65Y8SPQWKMWRHNZ0F1D432G,did:meca:0x7c58b9adc5e95291c5fbadc574c81c64374f7382,56,1687749186,1688097392,game_3d_rendering,348206
01H65Y8SXF7VR22A5TAVGJTR1G,did:meca:0x52ee6ae795c6b212db5b5bb549d61d5aa13ac072,68,1687754129,1687901054,game_3d_rendering,146925
01H65Y8SKA1KP733PH3539KSXF,did:meca:0x1788a923594fe3155cba81dc361d71f9d7d66813,30,1687777267,1687943007,vr_env_rendering,165740
01H65Y8SJFMQDG6BHZBXWSYSBQ,did:meca:0xf707f49e41771e120a2f6130a49c4257337a1a9a,11,1687793965,1687895151,game_3d_rendering,101186
01H65Y8T6DTTVFKGX5KBM7H9P1,did:meca:0xa92a9ed02533d769fd14885ba625069b09b3f397,22,1687815678,1687849433,game_3d_rendering,33755
01H65Y8SRVTRR7AJAM2SDQNVQC,did:meca:0xce2e3188c4ac25ad6828581315896bd80affc9b4,85,1687837409,1687999200,ml_lstm,161791
01H65Y8T35W0AQJV5WFBVG2MFY,did:meca:0xed913a30812501e2fa3794aabcc7a65e9a22388a,79,1687848789,1687967538,ml_lstm,118749
01H65Y8T2R9RFSYC92SHMAJBC0,did:meca:0xc64a304a60078bba8c4c9fd889629be985bb3d4c,59,1687891996,1688144806,ml_lstm,252810
01H65Y8SKKZPXWQ7W46M6S5P6W,did:meca:0xf0d09a4096837835668ab1e033b4cd0d46b491c5,51,1687907712,1688104897,ml_lstm,197185
01H65Y8T0R3FNCY9999M2QH72X,did:meca:0xd23de794a725b9b4293efba9a0d528e15393f488,66,1687941297,1687968475,ml_lstm,27178
01H65Y8T2EADQC7XSB7AVP0CSQ,did:meca:0x0f487080641f2624772be34f3e7fbfbd66a329c5,27,1687988684,1688042785,ml_lstm,54101
01H65Y8SS1PP9NMTV1753TMF40,did:meca:0x71b85dba3b21429b57b48e5a447770cdf6c51f35,29,1687993339,1688026969,ml_lstm,33630
01H65Y8T4XYQE43H9XAKSZ323F,did:meca:0x8854c77a67ce36e4e6cdacbbaa57a55756717b98,37,1688007003,1688078235,ml_lstm,71232
01H65Y8SKW4PCEAS5NSQBNWDK3,did:meca:0xe48041457e3c83b410b71ed1cd15278367ebad48,40,1688009024,1688356730,ml_lstm,347706
01H65Y8T2QAVMT44JV6NT5074J,did:meca:0x86f60c88afb2a0219b3e390af5b8c1312473e58e,57,1688011047,1688172120,ml_lstm,161073
01H65Y8SN5HW62Y1Y9QC3ZXSDY,did:meca:0x1c4a142e1702a17f60b303abebfc08b2d53d87a4,52,1688047361,1688175696,game_3d_rendering,128335
01H65Y8T1NXY1T6HR6H5WQW26J,did:meca:0x67c442309e4c2cb7f82e79b486992cb77bf45181,68,1688051687,1688152018,game_3d_rendering,100331
01H65Y8T7YJQ894J2Z2NFC77JT,did:meca:0x07606c5c65f947549c5c7330f79057950f5bc5de,71,1688070640,1688225269,game_3d_rendering,154629
01H65Y8T4MNH5FHHGVPHMZEK8B,did:meca:0x436c123abba03ed9eeb57e38220f9c8962d13f8e,8,1688077830,1688178031,game_3d_rendering,100201
01H65Y8T5HYTP4GZE5EP7BC5GH,did:meca:0x62ceb8af37d8317441d625efe468ae4a282498fc,39,1688092489,1688362618,vr_env_rendering,270129
01H65Y8SSS3BFC7T8CC2RFY33P,did:meca:0x981117fc07c025be100444073aa194c45d4186c4,27,1688155959,1688275825,ml_lstm,119866
01H65Y8SMZ8CZ8EPW38JJK9NKX,did:meca:0xfc95762864d538ff346618de7f34d097da612d6c,94,1688162283,1688206416,ml_lstm,44133
01H65Y8SN9V8C80B5BSBJ80ZPH,did:meca:0x6c529567a6b46dda6fc1def88e370c4252d45237,18,1688168304,1688343529,ml_lstm,175225
01H65Y8T2EDWWZ3ZSD1RV2V0AK,did:meca:0x0c39e546e43f6a9da9ddd828d519e9c1eeb2ed2c,30,1688170683,1688345036,game_3d_rendering,174353
01H65Y8SZMR87XDGCSE1R6HK00,did:meca:0xc4ee20cea2938aef8038337fd50550220b7b25f9,94,1688204840,1688250626,game_3d_rendering,45786
01H65Y8SVEPMBZ0PGH31GVQBZ6,did:meca:0x3986bc35b2bcbd0340d90cc5b34b61edd0ff05c4,3,1688216197,1688453287,ml_lstm,237090
01H65Y8T3RV4K78X0QJZKHJHEQ,did:meca:0x19072f3e13b4462bb962a812c82cdd44dd646a78,88,1688231707,1688276660,ml_lstm,44953
01H65Y8T3NQ78Y7MWTJJ9MWFWF,did:meca:0x08f2b278b437c0cdd75c87ce1a9df4f295945453,37,1688265122,1688430148,game_3d_rendering,165026
01H65Y8SY7GX5KSCBF5C3XBF6Q,did:meca:0xabf46faaa54cd1b407f9fe1dbafed540b2f3c6bb,20,1688277224,1688296856,ml_lstm,19632
01H65Y8SRN5RJ55T2ZYE2SE088,did:meca:0x9fa315b10317a9f86d089170e5e52864ed2d88a2,42,1688299252,1688342106,game_3d_rendering,42854
01H65Y8SJNA94V002J9HHZ4238,did:meca:0x5842a3c506e16ed624eb4390fa431d9aef1b0a43,94,1688304727,1688537674,game_3d_rendering,232947
01H65Y8SKMT99X15RE5Y07QK2Y,did:meca:0xe0dd284a62e3ebf2e9dfcc410e3067949f8a66e5,94,1688310474,1688405787,vr_env_rendering,95313
01H65Y8SSF7WBXF0VCW7RKE295,did:meca:0x583f14145cbcb647fb27d6c8829dae15ca067fb9,62,1688344517,1688402474,ml_lstm,57957
01H65Y8T7EG4DETCH70JPNP9FW,did:meca:0xa98caec3bab6b96d14fb8064989c0319f141825b,5,1688348541,1688389041,vr_env_rendering,40500
01H65Y8T4H7PDNTFWGY2E61SER,did:meca:0x8e949c0a75ae5232c0b8b83ee467b91d3de5b1fc,24,1688373206,1688584037,game_3d_rendering,210831
01H65Y8T7F44XDTDMAB5V128P9,did:meca:0xb9bc4c36fffeacdd532fc3df84940ae00ba82951,83,1688375122,1688418754,game_3d_rendering,43632
01H65Y8STZ6HQW96Q3MG3F62JN,did:meca:0x60bf808a6e7e744fbdd49f15b64a224576ed1fe8,24,1688384689,1688492877,ml_lstm,108188
01H65Y8T7JS83FJE565814TVJE,did:meca:0x83aa973357a267690078fe24fb20afa7679baf04,92,1688408755,1688449892,game_3d_rendering,41137
01H65Y8SX1A4BJKPST1ZXD3FVF,did:meca:0xbeabb55f291176ceaaec55263f4fbcae335b9a50,97,1688455454,1688470610,ml_lstm,15156
01H65Y8SRM229JNJQHQYVDBPJ6,did:meca:0xcb8ee2f276eeb52ecbb4c4cc4b6fde6678c23a34,98,1688478613,1688527322,ml_lstm,48709
01H65Y8T15Q51S3V8ZEKMT139A,did:meca:0x4cf91834e6e6eb129164c75b7f09e1018cfc0c5a,26,1688483225,1688579366,game_3d_rendering,96141
01H65Y8SWAA6T23ETBJE7PWSC2,did:meca:0x985c5cb88f782256c6fcde6e771ed92337cc06bc,68,1688502720,1688781016,vr_env_rendering,278296
01H65Y8T30ZZHCDFZC0ZF3H1TT,did:meca:0xf009db97cfed1c8d034d748bf125bbf950663eb6,19,1688507266,1688605418,ml_lstm,98152
01H65Y8T5WFPYVADANEHVAJB1R,did:meca:0x2a1df77a851e761b40c9c177888d9f0e7ecdbc09,59,1688534689,1688674820,ml_lstm,140131
01H65Y8SJYZ57JT3HV3E3F99BA,did:meca:0x70226f43035fffcc97d95867681792acc6aabf4f,46,1688562005,1688783672,ml_lstm,221667
01H65Y8SVTV7CBJ483VH8XD0D9,did:meca:0xf3185d1f41d0eb5e5c23497bee3dc01c030a1b39,70,1688566699,1689014251,ml_lstm,447552
01H65Y8T4DY01M6Q3D9DW9A0YW,did:meca:0xd0e7964f86a60ad8dc14d16e4ea480b9326e1afa,61,1688584382,1688675957,game_3d_rendering,91575
01H65Y8T0WJM198SE7KXGGZQKW,did:meca:0x66903ddfe15b2b13310b6968750170869e4aaf8c,87,1688603123,1688655742,ml_lstm,52619
01H65Y8T4BDW8XNWVZ84HP92NM,did:meca:0xcc85243e08521161b2840ad5e2c85f05f0ab45d8,78,1688655330,1688981212,ml_lstm,325882
01H65Y8T4CFKM2H0NE4Q2BHPC3,did:meca:0xd452a23a9c5947b33c046a5a0db1854287f9f8b7,73,1688660073,1688916391,game_3d_rendering,256318
01H65Y8T057ZEMSWZHXSE1Q46F,did:meca:0x78eae931cee80120ce7a44f46893a1ae7193ca9f,93,1688662470,1688855944,ml_lstm,193474
01H65Y8T6HS1ZP7RG0T4X36EXM,did:meca:0xb59bb631afa4bf2565c2a91f5ec2fb277b2175f1,17,1688708856,1688809035,game_3d_rendering,100179
01H65Y8SM38K0F3H564W3NXR48,did:meca:0x98cf50612f394cbeedf6ffc31fe0a7f868d1d632,34,1688719003,1688728825,vr_env_rendering,9822
01H65Y8SWG2RPTGKBHWN6HMHHT,did:meca:0xf34f44d7ff7c5ea48180a32404283f08a1f1ace6,62,1688720370,1688861616,game_3d_rendering,141246
01H65Y8SREB78PK30094FW1QP5,did:meca:0xbb2a7720cd0a789fee84bdf4b5dcfabc67d4d261,95,1688728539,1688907423,ml_lstm,178884
01H65Y8T5TVM60ANF3SWAE24XX,did:meca:0x3e1260cff7dae59b63ac82dc8761557b34615f24,49,1688746090,1688819542,ml_lstm,73452
01H65Y8SR0NV5PTF4Q26FAX5AH,did:meca:0x55cebd6ff1b9f1c1d9dd2368c9dc0f9726f11e02,21,1688753412,1688851541,ml_lstm,98129
01H65Y8SN645RDXS5VAB5HH4HS,did:meca:0x7e3181cc2b60898cab5591eae60579abd8372efb,16,1688760300,1688799298,game_3d_rendering,38998
01H65Y8SKZGB7G6MMZ66WK7Y33,did:meca:0xb7e2f23dbbc61b2fb6fd50ec3aa08c41bfae4aba,70,1688782790,1688937321,ml_lstm,154531
01H65Y8SSTRC83H5563Z607TV9,did:meca:0xba7632bd2da11dae28d8df49d19edc8cd1ad5c2c,98,1688783826,1688924246,ml_lstm,140420
01H65Y8SPGK0XQBFB3H4CDH8Z8,did:meca:0x58a7b736ab9917ed9f4eae4fb33317170d5f4b4a,30,1688809193,1688886364,ml_lstm,77171
01H65Y8T0M5ZJ1YBCWWXYT75K4,did:meca:0x6f9d33c0303de86b093415e5727b9023b9ef6393,1,1688870657,1689115928,ml_lstm,245271
01H65Y8T1QVAH7HJFMKN048NC0,did:meca:0x04b7cb3ce087beaa133bd7d3ee4c9ae88fb36a19,32,1688899081,1689069447,ml_lstm,170366
01H65Y8T7XPXZF8VE4VBS74E46,did:meca:0xa89887a52a6509418ca3eb7a7229b55751698493,76,1688929394,1689066629,ml_lstm,137235
01H65Y8T1Z1NG5CXT5PHK548N2,did:meca:0x01aabbd5654e91d6a4af9a3977873574b6f02fa0,60,1689060889,1689147152,vr_env_rendering,86263
01H65Y8SVA94SAKE7KW0DXQF2M,did:meca:0x0c8b19222c1f423a4a8cafc7118db6489eb2f9f2,83,1689105889,1689157763,vr_env_rendering,51874
01H65Y8SXFA9WC8ZA1NNTGN9PA,did:meca:0x2ce2a4c7139cad7ce721ebc5beb74326199245a8,20,1689106539,1689424395,game_3d_rendering,317856
01H65Y8STTS13VNWFKER3Z13AC,did:meca:0x733e0a30f822181dd29ef6c10c6e8d64a7239007,10,1689121856,1689266493,vr_env_rendering,144637
01H65Y8SKW7ZE2ZBJ74Z0MAZ66,did:meca:0xeeb3ce75c81587ff5ea1aacecb4998aa5e168818,60,1689132926,1689183760,game_3d_rendering,50834
01H65Y8T4GQZVV953A5F660Y66,did:meca:0x217570228347577320754141aaf10cfb1921ab70,98,1689155327,1689328967,ml_lstm,173640
01H65Y8SMPFHZJHM69XQSEK826,did:meca:0xf5279265d2904397fc26a58808f246d66bf94d5e,92,1689162629,1689196103,ml_lstm,33474
01H65Y8T7B8BX3YAJXBD0WTVGF,did:meca:0x23dad4447ae910497c7ab6b5449d94df25d7b13a,52,1689172015,1689189394,vr_env_rendering,17379
01H65Y8T2V3Z3EC13AY2GH78M0,did:meca:0xdd090e6d16b310bc7d147f173c9461546cce49c3,59,1689177595,1689244803,ml_lstm,67208
01H65Y8T1C9XXXEV0YJTBSJMVS,did:meca:0x4aa5509fe63520d007a98e8d3146c264ee8ee219,47,1689183279,1689291426,game_3d_rendering,108147
01H65Y8SYZYPQX0S6JW7M9WQV7,did:meca:0xa74f95a4f8508031c0144aeee0b90e3b4582eb2b,5,1689186729,1689253739,ml_lstm,67010
01H65Y8SWT4V0117F1SKED797P,did:meca:0xfe49c80768e2ea6bd632555d6eba93c09d9fe382,83,1689188967,1689402468,game_3d_rendering,213501
01H65Y8SNH30T496WFB4TTYKEK,did:meca:0x9f47b5b7bd81ba2e0d564da5147dd8d0ed079dc2,71,1689191209,1689199137,game_3d_rendering,7928
01H65Y8T7YKXVQMJ868659KYE8,did:meca:0x22400635c4238b097df810450df011615614a936,92,1689194778,1689241952,game_3d_rendering,47174
01H65Y8SXQZMPVTDJ8WZQH2265,did:meca:0x6c3706415febdb3e5f0fae33f6edaff533a555c6,49,1689216510,1689390578,vr_env_rendering,174068
01H65Y8SPEDJD6VEKJJ9GF8JJX,did:meca:0x842d4ed360eb4599b717255f90d36aad012e161e,63,1689225116,1689534839,ml_lstm,309723
01H65Y8SNTRNQ3BCAH7YESFT6A,did:meca:0x6f21251add1573481fbb8cd4b897b8bb57975121,32,1689275491,1689297106,ml_lstm,21615
01H65Y8T70N857J84TT0SRQHDJ,did:meca:0xc98214d076157532147d559bc495930877407011,81,1689276790,1689333740,game_3d_rendering,56950
01H65Y8SN7VBE58TMZRDZM7JY6,did:meca:0x970d24c8475fc1c16c888a6427339ac103eac4a6,13,1689285763,1689307077,game_3d_rendering,21314
01H65Y8SMAZ9FJ90E5Y6D3VW7F,did:meca:0xb1e8db7d098ad8c9c3e088dcd7276f38bf49c5f9,30,1689323875,1689446510,game_3d_rendering,122635
01H65Y8T26CE90ZMD8STSV08VF,did:meca:0x18ec046527d7894346bbb05c04e94824d3a15b96,89,1689348650,1689409491,ml_lstm,60841
01H65Y8T5K0D5802MG11E573CZ,did:meca:0x6757b62edde510de10d511fda1a611e6af46f05c,75,1689368809,1689697833,ml_lstm,329024
01H65Y8SSQZTTPRR9CBN9C3BXF,did:meca:0x6feaa2d6810af00e901c228d1b4a0f44178a37d1,8,1689379155,1689441604,ml_lstm,62449
01H65Y8SMJGN8NCKDFBZDS3570,did:meca:0x5000ff1831108e21ea04dd2968adfc9e907f6259,30,1689392415,1689445781,game_3d_rendering,53366
01H65Y8T29RTMR4YV302Y5NPBA,did:meca:0xfdce9a75a46d19dabc85ed87d7cb67d94955e238,53,1689401706,1689498020,ml_lstm,96314
01H65Y8T60Z6P2RBRJZS1D8RKH,did:meca:0xc1b9b1c8b80adbded96b8b80bd062969405a379a,57,1689431568,1689495561,ml_lstm,63993
01H65Y8SY4BPZWNEMJQYSRHHB0,did:meca:0x7938f64bdcb55d6e44c26dd846140b00d6311ad0,53,1689450708,1689655224,ml_lstm,204516
01H65Y8SM37DQ1FJZJ2HZP64B2,did:meca:0x8c6ae1c5cad25ee4ed641ac4c9936f9794b21711,61,1689451141,1689469515,game_3d_rendering,18374
01H65Y8T6EYV0568K874150HRN,did:meca:0x1924b3b1f61f8f4e41d43a67997cc1bc2514d637,75,1689466225,1689652930,ml_lstm,186705
01H65Y8SNP0X42J76S8RZVSV9X,did:meca:0xa8ef2b39f3e5b49ca7f88eb59b2fafeedc029c0b,16,1689500300,1689552224,ml_lstm,51924
01H65Y8T62M3X25ZBBGT64JAPG,did:meca:0xb8a8b3b5b3d41fcca80411f0c3a6001553c1087f,72,1689503296,1689851120,game_3d_rendering,347824
01H65Y8T4RSXFXJF4ZH5B50YX0,did:meca:0xb2e2d053c26124696237065770a0e929544a4982,31,1689520922,1689621335,ml_dbn,100413
01H65Y8T61MJ67V6BVCSFKAHDK,did:meca:0x1f6dd94c53091ff752b700d66c41f451f3b3a2c0,52,1689529726,1689589621,ml_lstm,59895
01H65Y8T347D65ZVZQ8D8E4HEH,did:meca:0x87f18291a58292bce890ac0b6e9fb2e7020743e2,66,1689538114,1689603948,game_3d_rendering,65834
01H65Y8T21CAPR2XJ6T3J4MZ4G,did:meca:0x8a699780586a0d50b31a84e38a227737b34d6ce6,9,1689540237,1689686499,ml_lstm,146262
01H65Y8SNBEX1T8VN5XHDT6W32,did:meca:0x2114fa9703195c8d94ff0574d9135f4054684ed5,47,1689567064,1689677587,game_3d_rendering,110523
01H65Y8T75NEXQW9J96WJX66QF,did:meca:0x26ae9e36cfca7b8973c8b37aa54dc5e840a5b831,45,1689576058,1689632367,vr_env_rendering,56309
01H65Y8T49VNX3T7M9KQ6B21E3,did:meca:0xef3d56fba941e54f7716960ebef5a7d2848d0bce,14,1689585004,1689924576,game_3d_rendering,339572
01H65Y8SNQ0QKBPSZS7NH60TW4,did:meca:0xc9d0fa4e03a46a0c387d0554caa7b587aff4c0df,52,1689596434,1689673298,vr_env_rendering,76864
01H65Y8SZENRW7TQV4BVS8RKAG,did:meca:0xe73c5f181ca3abaf3dc3fd4157236fb4e8e5587f,72,1689614005,1689656332,ml_lstm,42327
01H65Y8SSC4PQTXPQKHAC56XS3,did:meca:0xabe19f15e65d801c7836dbf5abdd0266cda78b38,83,1689638210,1689703833,vr_env_rendering,65623
01H65Y8T6DA3Y4AT1WXYY8NJAF,did:meca:0xdf14ebf5015066578f5b3f7489a7e640b330b8bc,36,1689657511,1689879832,game_3d_rendering,222321
01H65Y8SPT2ECR1MXG58QYC7CC,did:meca:0xa2bda441d1ef0f4ea3d75e106873ff0fe3791c44,52,1689665535,1689837328,game_3d_rendering,171793
01H65Y8SWC7Y8AY8HFT4TNT8F7,did:meca:0x2d79f61dcadff47e85c9d91fdde11a286b0413e3,48,1689666661,1689763809,ml_lstm,97148
01H65Y8SXVD1872N1TFDH35PHH,did:meca:0x0e22191b69c8d90732735abde063de234cfdd4dd,88,1689669210,1689713135,ml_lstm,43925
01H65Y8SSW80ZQ4ES85RA38E4T,did:meca:0x3fd3d4c54a67ef59e7f7c8e2fd9f5e0fa8cedc32,90,1689730547,1689796812,ml_lstm,66265
01H65Y8T3Z6T93R7DB6WS4XMP0,did:meca:0x0d3c5ded87152d6d91e92611eb3c0c151ea47359,89,1689843227,1690050122,ml_lstm,206895
01H65Y8SV0RS4TRSJ8GFEBV3TG,did:meca:0x0a20afe623d19a2f59e2341526c382a9d7910fc2,88,1689854537,1689931706,ml_lstm,77169
01H65Y8SJ8AT46MDKD202QH2CC,did:meca:0x6ee1f93d81af8f3c72e0abb36ff0586bade33394,52,1689938423,1690067164,game_3d_rendering,128741
01H65Y8T1YV7MN1KPHKZTKWXS8,did:meca:0x4e4c65ba639d13afe18b2dac779130eca5193227,55,1689958957,1690118156,game_3d_rendering,159199
01H65Y8T12HHS431PE9JFEP7HX,did:meca:0x2c22e44c8307ae7e0e34012e7360bff4bcc3844e,16,1690097135,1690173889,game_3d_rendering,76754
01H65Y8SS5RR65XDKH7STHNVCM,did:meca:0xbd6c7fc9a2d74e6f9b3f572b4e18b4172e0d2969,36,1690102656,1690312406,ml_lstm,209750
01H65Y8T7TRTR80KCZZWD0YJ3C,did:meca:0xbcfece1080fcf6ab629e46a0df09262b3b4a1850,25,1690117462,1690273231,vr_env_rendering,155769
01H65Y8SQ50ZPAR6BGRSPRQBMG,did:meca:0xaa9c9a341bc9cd36535ccd728e85177ed81fb2ae,17,1690187743,1690274472,ml_lstm,86729
01H65Y8SMT2X3HJHT93GMST1AG,did:meca:0xead3727833b2b9c086d477d231e3e0e2c0263a23,61,1690224889,1690437110,ml_lstm,212221
01H65Y8SSA4WHX5B4AD7BZHRGQ,did:meca:0x04672047936e8811b462e94324fb159f9b4879d9,72,1690230097,1690352348,game_3d_rendering,122251
